arbeidsbureau	institut	1	bureau	arbeid	2
autorit	dynamic_conc	1	rit	auto	2
begraafplaats	place	1	plaats	begraven	2
bouwmateriaal	artefact	1	materiaal	bouw	2
dashond	nonhuman	1	hond	das	2
grafkamer	place	1	kamer	graf	2
houdbaarheidsdatum	time	1	datum	houdbaarheid	2
kinderopvang	institut	1	opvang	kind	2
landbouwer	human	1	bouwer	land	2
mannendag	time	1	dag	man	2
mensenhand	concrother	1	hand	mens	2
onderzoeker	human	1	zoeker	onder	2
schoonzoon	human	1	zoon	schoon	2
skateboard	artefact	1	board	skate	2
spaaractie	dynamic_abstr	1	actie	spaar	2
spaarpunt	nondynamic	1	punt	spaar	2
wachtkamer	place	1	kamer	wachten	2
winkelkar	artefact	1	kar	winkel	2
wintersport	nondynamic	1	sport	winter	2
woordvoerder	human	1	voerder	woord	2
zaterdagochtend	time	1	ochtend	zaterdag	2
zwerftocht	dynamic_abstr	1	tocht	zwerven	2
aandacht	nondynamic	0			
aandoening	nondynamic	0			
aanval	dynamic_abstr	0			
aanwezigen	human	0			
acht	undefined	0			
actie	dynamic_abstr	0			
afspraak	nondynamic	0			
al	undefined	0			
ALS	nondynamic	0			
appel	voed_verz	0			
april	time	0			
Arie	human	0			
arm	concrother	0			
armen	concrother	0			
as	artefact	0			
auto	artefact	0			
avond	time	0			
avonds	time	0			
b	nondynamic	0			
bakje	artefact	0			
bakker	human	0			
balans	nondynamic	0			
band	undefined	0			
bank	undefined	0			
bed	artefact	0			
been	substance_conc	0			
beenderen	concrother	0			
beetje	nondynamic	0			
begin	nondynamic	0			
behulp	nondynamic	0			
belang	nondynamic	0			
best	nondynamic	0			
bestaan	dynamic_abstr	0			
bestuurder	human	0			
betereen	substance_abstr	0			
beurt	nondynamic	0			
bezit	nondynamic	0			
biertje	voed_verz	0			
big	nonhuman	0			
bij	nonhuman	0			
bladzij	artefact	0			
bliksem	dynamic_conc	0			
blind	artefact	0			
blonde	human	0			
boek	artefact	0			
bof	undefined	0			
boot	artefact	0			
boots	human	0			
Bourgogne	voed_verz	0			
Boze	human	0			
brandweer	institut	0			
brief	artefact	0			
broek	artefact	0			
buitenlandse	human	0			
buts	concrother	0			
cadeau	artefact	0			
camera	artefact	0			
cartoon	nondynamic	0			
commentaar	nondynamic	0			
componist	human	0			
cultuur	nondynamic	0			
dag	time	0			
dak	artefact	0			
dans	dynamic_abstr	0			
Deen	human	0			
delict	dynamic_abstr	0			
Denemarken	place	0			
des	nondynamic	0			
Dexter	human	0			
ding	undefined	0			
dochter	human	0			
doden	human	0			
doen	dynamic_abstr	0			
does	artefact	0			
dood	nondynamic	0			
drempel	undefined	0			
Drenthe	place	0			
druk	dynamic_abstr	0			
duur	time	0			
echt	dynamic_abstr	0			
eeuw	time	0			
eik	nonhuman	0			
einde	undefined	0			
energie	nondynamic	0			
erg	nondynamic	0			
fiets	artefact	0			
Frans	nondynamic	0			
game	dynamic_abstr	0			
gang	undefined	0			
gas	substance_abstr	0			
gast	human	0			
gasten	human	0			
gebruik	dynamic_abstr	0			
gek	human	0			
gelegenheid	dynamic_abstr	0			
geloof	nondynamic	0			
geloop	dynamic_abstr	0			
generatie	nondynamic	0			
genoegen	nondynamic	0			
getal	nondynamic	0			
geur	concrother	0			
gevoel	nondynamic	0			
gevoelen	nondynamic	0			
geweld	nondynamic	0			
glas	artefact	0			
goed	undefined	0			
groep	undefined	0			
grond	undefined	0			
grote	nondynamic	0			
groten	nondynamic	0			
gymp	artefact	0			
haar	concrother	0			
half	undefined	0			
hersens	undefined	0			
hert	nonhuman	0			
hoes	artefact	0			
Hollywood	institut	0			
hond	nonhuman	0			
hoofd	undefined	0			
hor	artefact	0			
hout	substance_conc	0			
hui	substance_conc	0			
huis	place	0			
Hun	human	0			
hunebed	artefact	0			
i	nondynamic	0			
idee	nondynamic	0			
iets	artefact	0			
ik	human	0			
imperfectie	nondynamic	0			
indruk	nondynamic	0			
IS	institut	0			
ja	nondynamic	0			
jaar	time	0			
jager	human	0			
Jan	human	0			
jas	artefact	0			
jasje	artefact	0			
jeugd	time	0			
jong	human	0			
jongen	human	0			
jubilaris	human	0			
k	nondynamic	0			
kaartje	artefact	0			
Kamer	institut	0			
kamer	place	0			
kan	artefact	0			
kans	nondynamic	0			
keer	undefined	0			
Kees	human	0			
keuze	dynamic_abstr	0			
kijk	nondynamic	0			
kilo	measure	0			
kind	human	0			
kleed	artefact	0			
kleine	human	0			
kleren	artefact	0			
kom	undefined	0			
koning	human	0			
koningen	human	0			
kop	undefined	0			
Kos	place	0			
krijg	dynamic_abstr	0			
la	artefact	0			
lake	place	0			
las	artefact	0			
laten	dynamic_abstr	0			
leen	undefined	0			
leest	undefined	0			
lef	nondynamic	0			
lekkers	voed_verz	0			
leraar	human	0			
leraren	human	0			
leven	nondynamic	0			
licht	undefined	0			
liefhebber	human	0			
liter	place	0			
loop	undefined	0			
loopje	nondynamic	0			
los	nonhuman	0			
lul	undefined	0			
m	nondynamic	0			
maar	nondynamic	0			
machine	artefact	0			
man	human	0			
marathon	dynamic_conc	0			
markt	undefined	0			
ME	institut	0			
mee	undefined	0			
meen	nondynamic	0			
meent	place	0			
meer	place	0			
mees	nonhuman	0			
meisje	human	0			
mens	human	0			
mensen	human	0			
Meren	place	0			
merk	nondynamic	0			
merken	nondynamic	0			
mes	artefact	0			
MET	nondynamic	0			
metten	dynamic_abstr	0			
mevrouw	human	0			
middag	time	0			
middags	time	0			
mijn	nondynamic	0			
mobieltje	artefact	0			
moeder	human	0			
moederschap	nondynamic	0			
moes	substance_conc	0			
morgen	time	0			
morgens	time	0			
muur	place	0			
muziek	nondynamic	0			
naam	nondynamic	0			
Namen	place	0			
Nederland	place	0			
Nederlands	nondynamic	0			
Nederlandse	human	0			
net	undefined	0			
niets	nondynamic	0			
noord	place	0			
noorden	place	0			
nu	time	0			
obsessie	nondynamic	0			
OM	institut	0			
oma	human	0			
ons	measure	0			
ontslag	nondynamic	0			
oog	concrother	0			
opdracht	nondynamic	0			
opgraving	place	0			
optreden	nondynamic	0			
ouder	human	0			
ouders	human	0			
ouwe	human	0			
oven	artefact	0			
paar	undefined	0			
paars	concrother	0			
pan	artefact	0			
papa	human	0			
pas	undefined	0			
pass	dynamic_conc	0			
passen	nondynamic	0			
pet	artefact	0			
peter	human	0			
pets	dynamic_conc	0			
Piet	human	0			
plaatje	undefined	0			
plaats	undefined	0			
plank	artefact	0			
plek	undefined	0			
pot	artefact	0			
prinses	human	0			
probleem	nondynamic	0			
provincie	place	0			
publiek	human	0			
punt	undefined	0			
PvdA	institut	0			
recensie	nondynamic	0			
reden	nondynamic	0			
reep	undefined	0			
reis	dynamic_abstr	0			
rest	undefined	0			
resten	nondynamic	0			
rode	human	0			
roker	human	0			
rond	place	0			
ronde	nondynamic	0			
roodkapje	human	0			
ruim	place	0			
samenvatting	nondynamic	0			
scene	human	0			
schik	nondynamic	0			
scholen	place	0			
school	place	0			
Schrift	nondynamic	0			
schrijven	nondynamic	0			
seal	nondynamic	0			
situatie	nondynamic	0			
slaag	dynamic_conc	0			
slag	undefined	0			
slagen	dynamic_abstr	0			
software	nondynamic	0			
soort	nondynamic	0			
spelletje	nondynamic	0			
staat	undefined	0			
stad	place	0			
Staten	institut	0			
steen	substance_conc	0			
stoot	undefined	0			
straat	place	0			
strand	place	0			
streek	undefined	0			
stuk	undefined	0			
stuur	artefact	0			
t-shirt	artefact	0			
teen	concrother	0			
tekort	nondynamic	0			
tekst	nondynamic	0			
telefoon	artefact	0			
test	dynamic_abstr	0			
thuis	place	0			
tien	nondynamic	0			
tijd	time	0			
touw	artefact	0			
traan	substance_conc	0			
trap	undefined	0			
tree	artefact	0			
trek	undefined	0			
trouw	nondynamic	0			
Truus	human	0			
tweede	nondynamic	0			
twijfel	nondynamic	0			
u	nondynamic	0			
uitspraak	nondynamic	0			
uitzondering	nondynamic	0			
US	institut	0			
uur	time	0			
vampier	human	0			
verdriet	nondynamic	0			
vergadering	dynamic_abstr	0			
verhaal	nondynamic	0			
verkiezing	dynamic_abstr	0			
verkiezingen	nondynamic	0			
verleden	time	0			
verrassing	nondynamic	0			
vertrek	undefined	0			
verwachting	nondynamic	0			
verzamelaar	human	0			
vlam	concrother	0			
volume	nondynamic	0			
voor	undefined	0			
voordeel	nondynamic	0			
voorgaande	time	0			
voorraad	nondynamic	0			
vorm	undefined	0			
vraag	nondynamic	0			
vragen	nondynamic	0			
vriendin	human	0			
vrij	nondynamic	0			
vrouw	human	0			
waar	artefact	0			
waarom	nondynamic	0			
want	artefact	0			
waren	nondynamic	0			
was	undefined	0			
watten	artefact	0			
wedstrijd	dynamic_abstr	0			
wedstrijden	dynamic_abstr	0			
week	time	0			
weer	concrother	0			
weerstand	undefined	0			
weet	nondynamic	0			
weg	undefined	0			
wel	concrother	0			
wenkbrauw	concrother	0			
wereld	undefined	0			
werk	undefined	0			
werktuig	artefact	0			
weten	nondynamic	0			
wijs	nondynamic	0			
wil	nondynamic	0			
wilde	human	0			
Willem	human	0			
winkel	place	0			
wol	substance_conc	0			
wolf	nonhuman	0			
Word	institut	0			
zaag	artefact	0			
zeen	voed_verz	0			
zet	dynamic_abstr	0			
zij	undefined	0			
zijn	nondynamic	0			
zit	undefined	0			
zoekende	human	0			
zoen	dynamic_conc	0			
zoon	human	0			
zwarte	human	0			
zwijn	undefined	0			
