adhd	aandoening
ADHD	aandoening
a.d.h.d.	aandoening
A.D.H.D.	aandoening
Adhd	aandoening
A.d.h.d.	aandoening
Pdd-nos	aandoening
PDD-NOS	aandoening
pdd nos	aandoening
PDD NOS	aandoening
Pdd-Nos	aandoening
Pdd Nos	aandoening
PDD-NOS	aandoening
Add	aandoening
add	aandoening
ADD	aandoening
a.d.d.	aandoening
A.D.D.	aandoening
A.d.d.	aandoening
Add	aandoening
AIDS	aandoening
A.I.D.S.	aandoening
aids	aandoening
A.i.d.s.	aandoening
Aids	aandoening
a.i.d.s.	aandoening
CDA	politiek
CU	politiek
D66	politiek
GL	politiek
PvdA	politiek
PvdD	politiek
PVV	politiek
SGP	politiek
SP	politiek
VVD	politiek
50	politiek
OSF	politiek
ARP	politiek
CHU	politiek
KVP	politiek
RPF	politiek
GPV	politiek
CPN	politiek
PPR	politiek
PSP	politiek
EVP	politiek
SDAP	politiek
VDB	politiek
PvdV	politiek
FNP	politiek
NCPN	politiek
TROTS	politiek
PVM	politiek
GR	politiek
VCP	politiek
VSP	politiek
CDU	politiek
CSU	politiek
FDP	politiek
NPD	politiek
SSW	politiek
BIW	politiek
AfD	politiek
BP	politiek
ÖDP	politiek
REP	politiek
DKP	politiek
PBC	politiek
MLPD	politiek
DSU	politiek
BüSo	politiek
AUF	politiek
CM	politiek
BIG	politiek
ÖkoLinx	politiek
BGD	politiek
PSG	politiek
DP	politiek
FWD	politiek
GPD	politiek
KPD	politiek
ddp	politiek
SVP	politiek
RSB	politiek
MUD	politiek
MDU	politiek
UAP	politiek
LD	politiek
IPD	politiek
APPD	politiek
AB	politiek
APD	politiek
SPV	politiek
AGP	politiek
AViP	politiek
ADd	politiek
NSDAP	politiek
DVU	politiek
LDPD	politiek
LPF	politiek
KB	politiek
ADAV	politiek
AAA	zorg
AAPM	zorg
ABC	zorg
ACLS	zorg
ACS	zorg
Actiz	zorg
ADEAS	zorg
ADL	zorg
AED	zorg
AFM	zorg
AGIKO	zorg
AGZ	zorg
AIOS 	zorg
ALARAprincipe	zorg
ALS	zorg
AMC	zorg
AMI	zorg
AMS	zorg
ANIOS	zorg
ANW-Hoofd	zorg
AO/IC	zorg
AOA	zorg
APLS	zorg
ARBO	zorg
ARTI	zorg
ASA	zorg
ASP	zorg
ASTRO	zorg
ATLS	zorg
AWBZ	zorg
BACTS	zorg
BAPCOC	zorg
BBC	zorg
BBL	zorg
BBOV	zorg
BCP	zorg
BELAC	zorg
BEST	zorg
BFM	zorg
BHN	zorg
BHV	zorg
BICS	zorg
BIG	zorg
BIN	zorg
BIOMED	zorg
BIWAC	zorg
BKZ	zorg
BLS	zorg
BM	zorg
BMRO	zorg
BMW	zorg
BNP	zorg
BOL	zorg
BOOG	zorg
BOPZ	zorg
BPM	zorg
BPPC	zorg
BPR	zorg
BPS-WG	zorg
BRMO	zorg
BROK	zorg
BSC	zorg
BSN	zorg
BTC	zorg
BTD	zorg
BTW	zorg
BV	zorg
BVN	zorg
BW+	zorg
BZIO	zorg
CAB	zorg
CAO	zorg
CAPC	zorg
CAPD	zorg
CAZ	zorg
CB	zorg
CBO	zorg
CBOG	zorg
CBPR	zorg
CBS	zorg
CCKL	zorg
CCMO	zorg
CCMS	zorg
CCPD	zorg
CGG	zorg
CHP	zorg
CIBG	zorg
CIC	zorg
CIZ	zorg
CKCL:	zorg
CKV	zorg
CLIS	zorg
CMO	zorg
CMR	zorg
COC	zorg
COMPAZ	zorg
COPD	zorg
CPA	zorg
CPB	zorg
CPE	zorg
CQindex	zorg
CR	zorg
CR/NOV	zorg
CRNV-KNO	zorg
CSA	zorg
CS-steriel	zorg
CT	zorg
CTG	zorg
CTZ	zorg
CVA	zorg
CVR	zorg
CVZ	zorg
CZ	zorg
CZV	zorg
DBC	zorg
DBO	zorg
dICT:	zorg
DKS	zorg
DLCRG	zorg
DM	zorg
DMS	zorg
DMV	zorg
DOO	zorg
DOSschaal	zorg
DOT	zorg
DRG	zorg
DSM	zorg
DSMH	zorg
DSM-IV	zorg
DSRD	zorg
DVO	zorg
EAC	zorg
EAD	zorg
EANO	zorg
ECG	zorg
EDI	zorg
EFQM	zorg
EHH	zorg
EMD	zorg
ENPC	zorg
EORTC	zorg
EPA	zorg
EPD	zorg
EPID	zorg
EPLS	zorg
EPO	zorg
EQCP	zorg
ERASprotocol	zorg
ESBL	zorg
ESO	zorg
ESTRO	zorg
EVAR	zorg
EVLT	zorg
EVS	zorg
EVV	zorg
EZIS	zorg
F&I	zorg
FAB	zorg
FAGG	zorg
FANC	zorg
FAOT	zorg
FB	zorg
FCCSdiploma	zorg
FDGG	zorg
FMEA	zorg
FONA	zorg
FOOC	zorg
FTE	zorg
FWG	zorg
GBS	zorg
GGD	zorg
GGnet	zorg
GHOR	zorg
GIT	zorg
GMP	zorg
GMP-Z	zorg
GMSB	zorg
GRP	zorg
H&IP	zorg
HACCP	zorg
Hagro	zorg
HAIO	zorg
HAP	zorg
HbA	zorg
HDR	zorg
HFMEA	zorg
HH	zorg
HILA	zorg
HKM	zorg
HKZ	zorg
HL7	zorg
HOPE	zorg
HPAs	zorg
HRM	zorg
HSMR	zorg
HZP	zorg
I&A	zorg
IABP	zorg
IBC	zorg
IBS	zorg
IC	zorg
ICD	zorg
ICT	zorg
ID	zorg
ID-Pas	zorg
IFMS	zorg
IGZ	zorg
IHE	zorg
IKA	zorg
IKMN	zorg
IKNL	zorg
IKNO	zorg
IKZ	zorg
IMRT	zorg
INK	zorg
INVERT	zorg
IPB	zorg
IPC	zorg
iPROVA	zorg
ISO	zorg
ISQua 	zorg
IT	zorg
ITT	zorg
iUT	zorg
IVF	zorg
IVZ	zorg
JGZ	zorg
JPEG	zorg
KCHL	zorg
KClab	zorg
KF	zorg
KICK	zorg
KMVB	zorg
KNF	zorg
KNMG  	zorg
KNMP	zorg
KNO	zorg
KPC	zorg
KWO	zorg
KWS	zorg
LAD	zorg
LASER	zorg
LCM	zorg
LCR/MDL	zorg
LCR/NOG	zorg
LCR/NVN	zorg
LCRNIV	zorg
LCRNVA	zorg
LCRNVU	zorg
LCRNVVC	zorg
LDR	zorg
LEVV	zorg
LHCR	zorg
LKP	zorg
LMM	zorg
LMR	zorg
LOD	zorg
LPRGT	zorg
LPRL	zorg
LPvRM	zorg
LPZ	zorg
LTHP	zorg
LUTS	zorg
LVDT	zorg
LVR-2	zorg
LWNO	zorg
MBRT	zorg
MC	zorg
MDL	zorg
MDO	zorg
MDRD	zorg
MD-trajecten	zorg
METC	zorg
MFS	zorg
MIC	zorg
MID	zorg
MIP	zorg
MIT	zorg
MJOP	zorg
MMI	zorg
MMT	zorg
MOC	zorg
MOS	zorg
MRI	zorg
MRSA	zorg
MSC	zorg
MT	zorg
MUG	zorg
MUST	zorg
MVCT	zorg
MVGII	zorg
MZG	zorg
NABON	zorg
NBN	zorg
NCDR	zorg
NEN	zorg
NEN7510	zorg
NfN	zorg
NFU	zorg
NG	zorg
NIAZ	zorg
NIBP	zorg
NICE	zorg
Nictiz	zorg
NIVEL	zorg
NKP	zorg
NKR	zorg
NP	zorg
NPCF	zorg
NPO	zorg
NTA	zorg
NTD	zorg
NVIC	zorg
NVKF	zorg
NVKVV	zorg
NVKZ	zorg
NVMBR	zorg
NVOG	zorg
NVR	zorg
NVRO	zorg
NVSM	zorg
NVTZ	zorg
NVVC	zorg
NVVE	zorg
NVVN	zorg
NVvR	zorg
NVZ	zorg
NVZA	zorg
NVZD	zorg
NZa	zorg
O&G	zorg
O&O	zorg
OBU	zorg
OESO	zorg
OK	zorg
OMS	zorg
OPVS	zorg
OR	zorg
OSB	zorg
OTTO	zorg
OZRC	zorg
P&C	zorg
P&O	zorg
PA	zorg
PAAZ	zorg
PACE	zorg
PACS	zorg
PACU	zorg
PASIG	zorg
PC	zorg
PCC	zorg
PCI	zorg
PDMS	zorg
pg	zorg
PGB	zorg
PIH	zorg
PLB	zorg
PMO	zorg
PNIL	zorg
PO&O	zorg
POP	zorg
POS	zorg
POWI	zorg
PR	zorg
PREZIES	zorg
PRI	zorg
PRISMA	zorg
PSB 	zorg
PST 	zorg
PTCA	zorg
PvA	zorg
RASS	zorg
RAVHM	zorg
RD	zorg
RDS	zorg
RGC	zorg
RI&E	zorg
RIS.	zorg
RIVM	zorg
ROC	zorg
ROSIER	zorg
RSI	zorg
RT	zorg
RUMBA	zorg
RvA	zorg
RVB	zorg
RVE	zorg
RvT	zorg
RVZ	zorg
SAP	zorg
SEH	zorg
SFERD	zorg
SIT	zorg
SLA	zorg
SMART	zorg
SMR	zorg
SMT	zorg
SMUR	zorg
SNAQ	zorg
SPPS	zorg
SSCL	zorg
STZ	zorg
SWOT	zorg
TD	zorg
TeRM	zorg
THP	zorg
TNCC	zorg
TNO	zorg
TOC	zorg
TOP	zorg
TQM	zorg
TRALI	zorg
TRES	zorg
TTP	zorg
TU	zorg
TVB	zorg
TZ-OZ	zorg
uDSMH	zorg
UHV	zorg
UMCG	zorg
UMCN	zorg
UMCU	zorg
UN-keurmerk	zorg
UVIT	zorg
UWV	zorg
UZ	zorg
V&V	zorg
V&VN	zorg
VAIO	zorg
VAR	zorg
VBBA	zorg
VBH	zorg
VBS	zorg
VC	zorg
VCMO	zorg
VELO	zorg
VGM	zorg
VIM	zorg
VMP	zorg
VMS	zorg
VNG	zorg
VROM	zorg
VSV	zorg
VTGM	zorg
VVI	zorg
VVMI	zorg
VVT	zorg
VWO	zorg
VWS	zorg
VZI	zorg
WAO	zorg
WBMV	zorg
WBP	zorg
WCKZ	zorg
WCMS	zorg
WcZ	zorg
WFZ	zorg
WGBO	zorg
WGO	zorg
WHO	zorg
WIA	zorg
WIBAZ	zorg
WIP	zorg
WIV	zorg
WMCZ	zorg
Wmg	zorg
WMO	zorg
WOB	zorg
WOR	zorg
WTZi	zorg
WZC	zorg
XDS	zorg
XSD	zorg
ZBC	zorg
ZER	zorg
ZiROP	zorg
ZIS	zorg
ZIZO	zorg
ZonMW	zorg
ZPI	zorg
Zvw	zorg
ZZP	zorg
ZZZ	zorg
BA	onderwijs
DUO	onderwijs
h.a.v.o.	onderwijs
h.b.o.	onderwijs
h.b.s.	onderwijs
h.e.a.o.	onderwijs
H.t.s.	onderwijs
havo	onderwijs
HBO	onderwijs
hbs	onderwijs
HEAO	onderwijs
Hts	onderwijs
i.v.b.o.	onderwijs
IVBO	onderwijs
l.b.o.	onderwijs
l.E.A.O.	onderwijs
L.O.M.	onderwijs
L.T.S.	onderwijs
lbo	onderwijs
LEAO	onderwijs
lom	onderwijs
LOM	onderwijs
Lts	onderwijs
m.a.v.o.	onderwijs
m.b.o.	onderwijs
m.e.a.o.	onderwijs
M.T.S.	onderwijs
M.U.L.O.	onderwijs
MA 	onderwijs
mavo	onderwijs
MBO	onderwijs
MEAO	onderwijs
Mts	onderwijs
Mulo	onderwijs
o.b.s.	onderwijs
obs	onderwijs
v.b.o.	onderwijs
v.m.b.o.	onderwijs
vbo	onderwijs
vmbo	onderwijs
w.o.	onderwijs
WO	onderwijs
(pol.r.)	juridisch
(pres.)	juridisch
(vz.)	juridisch
(vzr.)	juridisch
A&O-fonds	juridisch
a.b.b.b.	juridisch
A.Hosp.	juridisch
a.i.	juridisch
aant.	juridisch
ABRS	juridisch
Acc.& Fisc.	juridisch
Acc.& Tax	juridisch
Acc.Act.	juridisch
Acc.Bedr.M.	juridisch
Acc.Bedr.T.	juridisch
Acc.Thema’s M.	juridisch
Act.dr.	juridisch
Act.dr.fam	juridisch
Act.fisc.	juridisch
Act.jur.baux	juridisch
Act.soc.	juridisch
Activa	juridisch
Ad Rem	juridisch
Adm.Lex	juridisch
Advocare	juridisch
afd.	juridisch
A-G	juridisch
AGB	juridisch
AI	juridisch
AK	juridisch
A-M	juridisch
Amén.	juridisch
Ann.dr.	juridisch
Ann.dr.Lg.	juridisch
Ann.dr.Louvain	juridisch
Ann.dr.sc.pol.	juridisch
Ann.ét.eur.	juridisch
Ann.fac.dr.Lg.	juridisch
Ann.jur.créd.	juridisch
Ann.jur.créd.règl.coll.	juridisch
Ann.not.	juridisch
Ann.parl.	juridisch
Ann.prat.comm.	juridisch
AöR	juridisch
Ar	juridisch
Arbbl.	juridisch
Arbh.	juridisch
Arbit.Besl.	juridisch
Arbrb.	juridisch
Arob	juridisch
arr.	juridisch
Arr.Cass.	juridisch
Arr.GwH	juridisch
Arr.R.v.St.	juridisch
Arr.RvS	juridisch
Arr.Verbr.	juridisch
Arrondrb.	juridisch
ARRS	juridisch
art.	juridisch
ASPO	juridisch
ATDF = A.T.D.	juridisch
AVA	juridisch
avas	juridisch
AVC	juridisch
avv	juridisch
B&W	juridisch
BA	juridisch
Balans	juridisch
Bank Fin.	juridisch
Bank Fin.(Cah.)	juridisch
Bank Fin.R.	juridisch
BayVBl.	juridisch
Bb&b	juridisch
BBN	juridisch
BD	juridisch
Benelux Jur.	juridisch
BES	juridisch
Beslagr.	juridisch
BEW	juridisch
bew.	juridisch
BGB	juridisch
BGH	juridisch
BGHZ	juridisch
bijl.	juridisch
bijv.	juridisch
BIOS	juridisch
BMI	juridisch
BNA	juridisch
BRL	juridisch
BRP	juridisch
BV 	juridisch
BVB	juridisch
BVO	juridisch
BVP	juridisch
BZ	juridisch
c.a.	juridisch
c.q.	juridisch
c.s.	juridisch
c.v.t.	juridisch
cass.	juridisch
cass. verw.	juridisch
CAVK	juridisch
CCRB	juridisch
CCV	juridisch
CCvD	juridisch
cf.	juridisch
cfm.	juridisch
CFV	juridisch
CI	juridisch
cie	juridisch
cie.	juridisch
Cie. Ber.schr.	juridisch
Cie. Verz.schr.	juridisch
circ.	juridisch
CIVD	juridisch
COELO	juridisch
concl.	juridisch
cons.	juridisch
coöp.	juridisch
cor	juridisch
Corr.	juridisch
curs.	juridisch
CV 	juridisch
d.d.	juridisch
Dep. Rl.	juridisch
dga	juridisch
DGOBR	juridisch
DHC	juridisch
DigiD	juridisch
diss.	juridisch
DÖV	juridisch
dr.	juridisch
drs.	juridisch
DT&V	juridisch
DUO	juridisch
DVBl.	juridisch
DWM	juridisch
DWR	juridisch
e.a.	juridisch
e.d.	juridisch
e.v.	juridisch
EC O&P	juridisch
ec. pol.r.	juridisch
ECU	juridisch
EGO	juridisch
EIA	juridisch
eindred.	juridisch
EK	juridisch
EL&I	juridisch
EN	juridisch
enac	juridisch
eNIK	juridisch
enz.	juridisch
eor	juridisch
EPS	juridisch
EUKN	juridisch
EV I	juridisch
EV II	juridisch
evt.	juridisch
facs. Uitg.	juridisch
FCIB	juridisch
FGZ	juridisch
fifo	juridisch
FMH	juridisch
FMN	juridisch
ftp	juridisch
g.v.o.	juridisch
GA	juridisch
GAB	juridisch
GBA-V	juridisch
GBR	juridisch
gem.	juridisch
GG	juridisch
GmbH	juridisch
gor	juridisch
GS	juridisch
GSM 	juridisch
Gst.	juridisch
GwH	juridisch
ha	juridisch
Hand.	juridisch
Handelingen I	juridisch
Handelingen II	juridisch
HBD	juridisch
hfdst.	juridisch
Hof	juridisch
Hrsg.	juridisch
i.b.s.	juridisch
i.c.	juridisch
i.o.	juridisch
i.s.m.	juridisch
i.t.t.	juridisch
i.v.m.	juridisch
i.v.s.	juridisch
i.w.tr.	juridisch
IAR	juridisch
IB	juridisch
IdM	juridisch
IDMI	juridisch
IenM	juridisch
II	juridisch
IMKO	juridisch
ing.	juridisch
InvW	juridisch
IOM	juridisch
IP 	juridisch
IPO	juridisch
IPR	juridisch
ir.	juridisch
ITK	juridisch
IVBPR	juridisch
JB	juridisch
JBZ Raad	juridisch
jl.	juridisch
jo.	juridisch
jrg.	juridisch
k.	juridisch
k.g.	juridisch
KBA	juridisch
KEI	juridisch
Kh.	juridisch
KI	juridisch
KING	juridisch
KNBV	juridisch
Kr.	juridisch
KT	juridisch
Ktg.	juridisch
Ktr.	juridisch
KVB	juridisch
l.k.	juridisch
LBA	juridisch
LBO	juridisch
LFMO	juridisch
lifo	juridisch
LJN	juridisch
LNB	juridisch
LOM	juridisch
losbl.	juridisch
LPCB	juridisch
LPNA	juridisch
LSA	juridisch
LTV	juridisch
M en	juridisch
M.	juridisch
m.a.	juridisch
m.k.	juridisch
m.nt.	juridisch
mGBA	juridisch
MIA	juridisch
mij.	juridisch
Mil.Ger.	juridisch
Min. Reg.	juridisch
MKB-NL	juridisch
mr.	juridisch
MvA	juridisch
mw. of mevr.	juridisch
NARIM	juridisch
NB	juridisch
NCP	juridisch
NEV I [tot	juridisch
NEV II [tot	juridisch
NIBRA	juridisch
NICIS	juridisch
Nirov	juridisch
NJ	juridisch
NJB	juridisch
NJU	juridisch
NMI	juridisch
NMP	juridisch
NPC	juridisch
NPI	juridisch
nr.	juridisch
NTB	juridisch
NUP	juridisch
NV	juridisch
NV 	juridisch
NV I	juridisch
NV II	juridisch
NVB	juridisch
NVBK	juridisch
NVBR	juridisch
NvT	juridisch
NVVY	juridisch
NvW	juridisch
O.	juridisch
o.a.	juridisch
o.t.s.	juridisch
o.t.t.z.	juridisch
OC&W	juridisch
OCV	juridisch
OEM	juridisch
OGB	juridisch
OGP	juridisch
OGS	juridisch
OK	juridisch
ONRI	juridisch
OO	juridisch
OTP	juridisch
OZB	juridisch
p.	juridisch
p.v.	juridisch
par.	juridisch
Parl. Gesch.	juridisch
PBO	juridisch
PG Awb I	juridisch
PG Awb II	juridisch
PIVA	juridisch
PK	juridisch
PKB	juridisch
PKVW	juridisch
plv.	juridisch
Pol.	juridisch
POMO	juridisch
pres.	juridisch
proc.	juridisch
prof.	juridisch
Prot.	juridisch
prov.	juridisch
pvt	juridisch
r.k.	juridisch
r.o.	juridisch
RANOV	juridisch
RAwb	juridisch
Rb.	juridisch
R-C	juridisch
REB	juridisch
red.	juridisch
REQ	juridisch
Res.	juridisch
resp.	juridisch
Rgd	juridisch
Rk.	juridisch
RNI	juridisch
Romazo	juridisch
ROVC	juridisch
RU	juridisch
RvdW	juridisch
RvO	juridisch
RvV	juridisch
RWS	juridisch
RWT	juridisch
S&V	juridisch
SCM	juridisch
SCV	juridisch
SE	juridisch
SEV	juridisch
SMVP	juridisch
SNB	juridisch
sofinr.	juridisch
SSC-ICT	juridisch
SSO	juridisch
st.	juridisch
Stb.	juridisch
Stc.	juridisch
Su.	juridisch
subs.	juridisch
suppl.	juridisch
T&C	juridisch
T&C Awb	juridisch
t.b.r.	juridisch
t.l.l.	juridisch
t.l.v.	juridisch
t.v.v.d.b.	juridisch
t.w.kr.	juridisch
t/m	juridisch
TAR	juridisch
tB/S	juridisch
TK	juridisch
toel.	juridisch
TP	juridisch
TRIPs	juridisch
tul	juridisch
TvO	juridisch
TVVS	juridisch
UA	juridisch
UB 	juridisch
UCV	juridisch
URL	juridisch
UvW	juridisch
V en M	juridisch
v.h.	juridisch
v.i.	juridisch
v.v.	juridisch
VAMIL	juridisch
VBBS	juridisch
VBN	juridisch
VEB	juridisch
VEBON	juridisch
ver.k.	juridisch
Verslag I	juridisch
Verslag II	juridisch
VGB	juridisch
vgl.	juridisch
VHS	juridisch
vlg.	juridisch
VNS	juridisch
Vo.	juridisch
VOF	juridisch
Voorz.	juridisch
VPB	juridisch
VPT	juridisch
Vred.	juridisch
vs.	juridisch
VSI	juridisch
VV I	juridisch
VV II	juridisch
VVB	juridisch
VvBO	juridisch
VvIB	juridisch
VVR	juridisch
VwGO	juridisch
VWN	juridisch
VwVfG	juridisch
Vz.	juridisch
VZA	juridisch
WEVAB	juridisch
WEW	juridisch
WKCZ	juridisch
wnd.	juridisch
WPNR	juridisch
Wrr.	juridisch
Wrr.Ber.	juridisch
WWW	juridisch
z.j.	juridisch
z.p.	juridisch
A.A.	overige_instanties
AA	overige_instanties
AAA	overige_instanties
AAPM	overige_instanties
AAW	overige_instanties
AB	overige_instanties
ABB	overige_instanties
ABC	overige_instanties
ABOP	overige_instanties
abp	overige_instanties
ABRvS	overige_instanties
ABRvS (vz.)	overige_instanties
ABVA KABO	overige_instanties
ACLS	overige_instanties
ACOA	overige_instanties
ACS	overige_instanties
Actiz	overige_instanties
ad	overige_instanties
ADEAS	overige_instanties
ADL	overige_instanties
AED	overige_instanties
AFM	overige_instanties
AGFA	overige_instanties
AGIKO	overige_instanties
agn	overige_instanties
AGRvS	overige_instanties
AGRvS (vz.)	overige_instanties
AGZ	overige_instanties
AID	overige_instanties
AIOS 	overige_instanties
AIVD	overige_instanties
AKA	overige_instanties
ALARA principe	overige_instanties
ALS	overige_instanties
AMC	overige_instanties
AMI	overige_instanties
AMS	overige_instanties
ANIOS	overige_instanties
anvr	overige_instanties
ANW-Hoofd	overige_instanties
AO	overige_instanties
AO/IC	overige_instanties
AOA	overige_instanties
AOK	overige_instanties
AOV	overige_instanties
APLS	overige_instanties
ARBO	overige_instanties
ARRvS	overige_instanties
ARRvS (vz.)	overige_instanties
ARTI	overige_instanties
ASA	overige_instanties
ASP	overige_instanties
ASTRO	overige_instanties
ATLS	overige_instanties
AVO	overige_instanties
AWBZ	overige_instanties
AZ	overige_instanties
BACTS	overige_instanties
BALJON	overige_instanties
BAPCOC	overige_instanties
bb	overige_instanties
BBC	overige_instanties
BBL	overige_instanties
BBO	overige_instanties
BBOV	overige_instanties
BBSC	overige_instanties
BCP	overige_instanties
Bedrijfscie. 	overige_instanties
BELAC	overige_instanties
BenGH	overige_instanties
BEST	overige_instanties
BFM	overige_instanties
BH&C	overige_instanties
BHN	overige_instanties
BHV	overige_instanties
BICS	overige_instanties
BIG	overige_instanties
BIN	overige_instanties
BIOMED	overige_instanties
BIS	overige_instanties
BIWAC	overige_instanties
BiZa	overige_instanties
BKZ	overige_instanties
BLEU	overige_instanties
BLS	overige_instanties
BM	overige_instanties
BMB	overige_instanties
BMM	overige_instanties
BMRO	overige_instanties
BMW	overige_instanties
BNG	overige_instanties
BNP	overige_instanties
BO	overige_instanties
BOL	overige_instanties
BOOG	overige_instanties
BOP	overige_instanties
BOPZ	overige_instanties
BPM	overige_instanties
BPPC	overige_instanties
BPR	overige_instanties
BPS-WG	overige_instanties
BPT	overige_instanties
BPV	overige_instanties
BPVO	overige_instanties
BRMO	overige_instanties
BROK	overige_instanties
BSC	overige_instanties
BSN	overige_instanties
BTC	overige_instanties
BTD	overige_instanties
btg	overige_instanties
BTG HTV	overige_instanties
BTW	overige_instanties
BuZa	overige_instanties
BV	overige_instanties
bve	overige_instanties
BVH	overige_instanties
BVN	overige_instanties
BW	overige_instanties
BW+	overige_instanties
BZIO	overige_instanties
BZK	overige_instanties
CAB	overige_instanties
CAK	overige_instanties
CAO	overige_instanties
CAPC	overige_instanties
CAPD	overige_instanties
CAZ	overige_instanties
CB	overige_instanties
CBB	overige_instanties
CBB (EK)	overige_instanties
CBB (MK)	overige_instanties
CBB (pres.)	overige_instanties
CBB (vz.)	overige_instanties
CBB (vzr.)	overige_instanties
CBE	overige_instanties
CBHO	overige_instanties
CBO	overige_instanties
CBOG	overige_instanties
CBP	overige_instanties
CBPR	overige_instanties
CBPR 	overige_instanties
CBS	overige_instanties
CC	overige_instanties
CCKL	overige_instanties
CCMO	overige_instanties
CCMS	overige_instanties
CCPD	overige_instanties
CEDEFOP	overige_instanties
Cepina	overige_instanties
CƒI	overige_instanties
CFO	overige_instanties
CGB	overige_instanties
CGG	overige_instanties
CHP	overige_instanties
CIBG	overige_instanties
CIC	overige_instanties
CINOP	overige_instanties
CITO	overige_instanties
CIZ	overige_instanties
CKCL:	overige_instanties
CKV	overige_instanties
CLIS	overige_instanties
CMO	overige_instanties
CMR	overige_instanties
cnv	overige_instanties
cob	overige_instanties
COC	overige_instanties
colo	overige_instanties
COMPAZ	overige_instanties
COPD	overige_instanties
COWI	overige_instanties
CPA	overige_instanties
CPB	overige_instanties
CPE	overige_instanties
CQ index	overige_instanties
CR	overige_instanties
CR NV- KNO	overige_instanties
CR/ NOV	overige_instanties
CREBO	overige_instanties
CRI	overige_instanties
CRM	overige_instanties
CRvB	overige_instanties
CRvB 	overige_instanties
CRvB (vz.)	overige_instanties
CRvB (vzr.)	overige_instanties
CSA	overige_instanties
CS-steriel	overige_instanties
CT	overige_instanties
CT-Breed	overige_instanties
CTG	overige_instanties
CTZ	overige_instanties
CVA	overige_instanties
CvB	overige_instanties
CVR	overige_instanties
CVSE	overige_instanties
CVZ	overige_instanties
CWI	overige_instanties
CZ	overige_instanties
CZV	overige_instanties
DB	overige_instanties
DBC	overige_instanties
DBO	overige_instanties
DG	overige_instanties
dICT:	overige_instanties
DKS	overige_instanties
DLCRG	overige_instanties
DM	overige_instanties
DMS	overige_instanties
DMV	overige_instanties
DNB	overige_instanties
Doc. SV	overige_instanties
DOLO	overige_instanties
DOO	overige_instanties
DOS schaal	overige_instanties
DOT	overige_instanties
DRG	overige_instanties
DSMH	overige_instanties
DSM-IV	overige_instanties
DSRD	overige_instanties
Dte	overige_instanties
DVO	overige_instanties
EAC	overige_instanties
EAD	overige_instanties
EANO	overige_instanties
EB-kamer	overige_instanties
ECABO	overige_instanties
ECD	overige_instanties
ECG	overige_instanties
ECM	overige_instanties
Ecosoc EG	overige_instanties
ECOSOC UN	overige_instanties
ECRM	overige_instanties
EDI	overige_instanties
EEG	overige_instanties
EER	overige_instanties
EESV	overige_instanties
EFQM	overige_instanties
EG	overige_instanties
EGKS	overige_instanties
EHH	overige_instanties
EHRM	overige_instanties
EMD	overige_instanties
EMF	overige_instanties
EMS	overige_instanties
EMU	overige_instanties
ENPC	overige_instanties
EORTC	overige_instanties
EP	overige_instanties
EPA	overige_instanties
EPD	overige_instanties
EPID	overige_instanties
EPLS	overige_instanties
EPO	overige_instanties
EQCP	overige_instanties
ERAS protocol	overige_instanties
ESBL	overige_instanties
ESF	overige_instanties
ESO	overige_instanties
ESTRO	overige_instanties
EU	overige_instanties
euhofa	overige_instanties
EUR	overige_instanties
Euratom	overige_instanties
EV	overige_instanties
EVA	overige_instanties
EVAR	overige_instanties
EVC	overige_instanties
evk	overige_instanties
EVLT	overige_instanties
EVS	overige_instanties
EVV	overige_instanties
EZ	overige_instanties
EZIS	overige_instanties
F&I	overige_instanties
FAB	overige_instanties
FAGG	overige_instanties
FANC  	overige_instanties
FAO	overige_instanties
FAOT	overige_instanties
FB	overige_instanties
FbG	overige_instanties
fbi	overige_instanties
FBV	overige_instanties
FCCS diploma	overige_instanties
FD	overige_instanties
FDGG	overige_instanties
fem	overige_instanties
FEZ	overige_instanties
FG	overige_instanties
FIOD	overige_instanties
Flex Base	overige_instanties
FMEA	overige_instanties
fnv	overige_instanties
FONA	overige_instanties
FOOC	overige_instanties
Foor	overige_instanties
FTE	overige_instanties
FVP	overige_instanties
FWG	overige_instanties
GBS	overige_instanties
GGD	overige_instanties
GGnet	overige_instanties
GHOR	overige_instanties
GIT	overige_instanties
GMP	overige_instanties
GMP-Z	overige_instanties
GMSB	overige_instanties
GO	overige_instanties
GOA	overige_instanties
GOC	overige_instanties
GOV	overige_instanties
GRP	overige_instanties
GSI	overige_instanties
H	overige_instanties
H&IP	overige_instanties
HACCP	overige_instanties
Hagro	overige_instanties
HAIO	overige_instanties
HAO	overige_instanties
HAP	overige_instanties
HAVO	overige_instanties
HbA	overige_instanties
HBI	overige_instanties
HBO	overige_instanties
HDR	overige_instanties
HFMEA	overige_instanties
HFMEA 	overige_instanties
HH	overige_instanties
HHS	overige_instanties
HILA	overige_instanties
HKM	overige_instanties
HKZ	overige_instanties
HL7	overige_instanties
HMG	overige_instanties
HO	overige_instanties
HOPE	overige_instanties
horeca	overige_instanties
hov	overige_instanties
HPAs	overige_instanties
HR	overige_instanties
HR (P-G)	overige_instanties
HR (pres.)	overige_instanties
HRM	overige_instanties
HSMR	overige_instanties
hTV	overige_instanties
Huurcie. 	overige_instanties
Huurcie.  	overige_instanties
HvD	overige_instanties
HvJ EG	overige_instanties
HvJ EG (P-G)	overige_instanties
HvJ EG (pres.)	overige_instanties
HvJ NA	overige_instanties
HvJ NA en Aruba	overige_instanties
HvJ Suriname	overige_instanties
HZP	overige_instanties
I&A	overige_instanties
IAB	overige_instanties
IABP	overige_instanties
IAO	overige_instanties
IBC	overige_instanties
IBDB	overige_instanties
IBG-groep	overige_instanties
IBS	overige_instanties
IBW	overige_instanties
IC	overige_instanties
ICC	overige_instanties
ICD	overige_instanties
ICJ	overige_instanties
ICT	overige_instanties
ID	overige_instanties
ID-Pas	overige_instanties
IDW	overige_instanties
IFMS	overige_instanties
IGZ	overige_instanties
IHE	overige_instanties
IiP	overige_instanties
IIT	overige_instanties
IK	overige_instanties
IKA	overige_instanties
IKMN	overige_instanties
IKNL	overige_instanties
IKNO	overige_instanties
IKZ	overige_instanties
ILO	overige_instanties
IMF	overige_instanties
IMRT	overige_instanties
INK	overige_instanties
INNOVAM	overige_instanties
INTECHNIUM	overige_instanties
INVERT 	overige_instanties
IPB	overige_instanties
IPC	overige_instanties
iPROVA 	overige_instanties
ISO	overige_instanties
ISQua 	overige_instanties
ISZW	overige_instanties
IT	overige_instanties
IT 	overige_instanties
ITT	overige_instanties
ITU	overige_instanties
iUT	overige_instanties
IVF	overige_instanties
IVZ	overige_instanties
JGZ	overige_instanties
JOB	overige_instanties
JPEG	overige_instanties
KB	overige_instanties
kbb	overige_instanties
KBO	overige_instanties
KC lab	overige_instanties
KCE	overige_instanties
KCHL	overige_instanties
KF	overige_instanties
khn	overige_instanties
KICK	overige_instanties
KMVB	overige_instanties
KNB	overige_instanties
KNF	overige_instanties
KNMG  	overige_instanties
KNMP	overige_instanties
KNO	overige_instanties
KOC	overige_instanties
KPC	overige_instanties
KS	overige_instanties
KSF’n	overige_instanties
Ktr. 	overige_instanties
KUB	overige_instanties
KUN	overige_instanties
KvK	overige_instanties
KWO	overige_instanties
KWS 	overige_instanties
LAD	overige_instanties
LASER	overige_instanties
LCM	overige_instanties
LCR NIV	overige_instanties
LCR NVA	overige_instanties
LCR NVU	overige_instanties
LCR NVVC	overige_instanties
LCR/ MDL	overige_instanties
LCR/ NOG	overige_instanties
LCR/ NVN	overige_instanties
LDR	overige_instanties
LEVV	overige_instanties
LHCR	overige_instanties
Lisv	overige_instanties
LKP	overige_instanties
LMM	overige_instanties
LMP	overige_instanties
LMR	overige_instanties
LMT	overige_instanties
LNV	overige_instanties
LOB	overige_instanties
LOD	overige_instanties
L-OVD	overige_instanties
LPRGT	overige_instanties
LPRL	overige_instanties
LPvRM	overige_instanties
LPZ	overige_instanties
LTHP	overige_instanties
lttr	overige_instanties
LUTS	overige_instanties
LVDT	overige_instanties
LVR-2	overige_instanties
LWNO	overige_instanties
LWT	overige_instanties
MAS	overige_instanties
MAVO	overige_instanties
MBO	overige_instanties
MBRT	overige_instanties
MC	overige_instanties
MDL	overige_instanties
MDO	overige_instanties
MDRD	overige_instanties
MD-trajecten 	overige_instanties
METC	overige_instanties
MFS	overige_instanties
MGK	overige_instanties
MHO/MHS	overige_instanties
MIC	overige_instanties
MID	overige_instanties
MIP	overige_instanties
MIS	overige_instanties
MIT	overige_instanties
MJOP	overige_instanties
MMI	overige_instanties
MMT	overige_instanties
MOC	overige_instanties
MOS	overige_instanties
MRI	overige_instanties
MRSA	overige_instanties
MSC	overige_instanties
MT	overige_instanties
MTRO	overige_instanties
MUG 	overige_instanties
MUST	overige_instanties
MVCT	overige_instanties
MvD	overige_instanties
MvF	overige_instanties
MVG II	overige_instanties
MvJ	overige_instanties
MVT	overige_instanties
MZG	overige_instanties
NAB/NABV	overige_instanties
NABON	overige_instanties
NAI	overige_instanties
NATO	overige_instanties
NAVO	overige_instanties
nbc	overige_instanties
NBN	overige_instanties
NBOV	overige_instanties
NBT	overige_instanties
NCDR	overige_instanties
NEa	overige_instanties
NEN	overige_instanties
NEN 7510	overige_instanties
NfN	overige_instanties
NFU	overige_instanties
NG	overige_instanties
NGB	overige_instanties
NIAZ	overige_instanties
NIBP	overige_instanties
NICE	overige_instanties
Nictiz	overige_instanties
NIVEL	overige_instanties
NIVRA	overige_instanties
NJV	overige_instanties
NKP	overige_instanties
NKR	overige_instanties
NMa	overige_instanties
NMa (D-G)	overige_instanties
NNI	overige_instanties
NOAB	overige_instanties
NOB	overige_instanties
NOVA	overige_instanties
NOvAA	overige_instanties
NOVAK	overige_instanties
NOZEMA	overige_instanties
NP	overige_instanties
NPCF	overige_instanties
NPO	overige_instanties
NTA	overige_instanties
NTD	overige_instanties
NVIC	overige_instanties
NVIR	overige_instanties
NVKF	overige_instanties
NVKVV	overige_instanties
NVKZ	overige_instanties
NVMBR	overige_instanties
NVOG	overige_instanties
NVR	overige_instanties
NVRO	overige_instanties
NVSM	overige_instanties
NVSNVL	overige_instanties
NVTZ	overige_instanties
NVVC	overige_instanties
NVVE	overige_instanties
NVVN	overige_instanties
NVvR	overige_instanties
NVZ	overige_instanties
NVZA	overige_instanties
NVZD	overige_instanties
Nza	overige_instanties
O&G	overige_instanties
O&O	overige_instanties
OB	overige_instanties
OBU	overige_instanties
occ	overige_instanties
OCW	overige_instanties
OECD	overige_instanties
OER	overige_instanties
OESO	overige_instanties
OK 	overige_instanties
OM	overige_instanties
OMS 	overige_instanties
OPTA	overige_instanties
OPVS	overige_instanties
OR	overige_instanties
OREL	overige_instanties
OSB	overige_instanties
OT	overige_instanties
OTTO	overige_instanties
OU	overige_instanties
OV	overige_instanties
OVDB LOB	overige_instanties
OVSE	overige_instanties
OZRC 	overige_instanties
P&C	overige_instanties
P&O	overige_instanties
PA	overige_instanties
PAAZ	overige_instanties
PACE	overige_instanties
PACS	overige_instanties
PACU	overige_instanties
PAP	overige_instanties
PASIG	overige_instanties
PC	overige_instanties
PCC	overige_instanties
PCI	overige_instanties
pdca-cyclus	overige_instanties
PDMS	overige_instanties
PE	overige_instanties
PEMBA	overige_instanties
pg	overige_instanties
PGB	overige_instanties
PI’n	overige_instanties
PIH	overige_instanties
PLB	overige_instanties
PM	overige_instanties
PMO	overige_instanties
PNIL	overige_instanties
PO&O	overige_instanties
POK	overige_instanties
POP	overige_instanties
POS	overige_instanties
POWI 	overige_instanties
PPC	overige_instanties
PR	overige_instanties
PREZIES 	overige_instanties
PRI	overige_instanties
PRINCE	overige_instanties
PRISMA	overige_instanties
PS	overige_instanties
PSB 	overige_instanties
PST 	overige_instanties
PT	overige_instanties
PTCA	overige_instanties
PvA	overige_instanties
PVK	overige_instanties
PVP	overige_instanties
QMP	overige_instanties
RASS	overige_instanties
RAVHM	overige_instanties
RBA	overige_instanties
RD	overige_instanties
RDS	overige_instanties
recron	overige_instanties
RGC	overige_instanties
RI&E	overige_instanties
Rif	overige_instanties
RIS.	overige_instanties
RIVM	overige_instanties
RJ	overige_instanties
ROBO	overige_instanties
ROC	overige_instanties
ROHO	overige_instanties
ROSIER	overige_instanties
RPC	overige_instanties
RPD	overige_instanties
RSI	overige_instanties
RT	overige_instanties
RUG	overige_instanties
RUMBA	overige_instanties
RvA	overige_instanties
RVB	overige_instanties
RVD	overige_instanties
RvdJ	overige_instanties
RvdK	overige_instanties
RVE	overige_instanties
RvS	overige_instanties
RvT	overige_instanties
RVZ	overige_instanties
SAP	overige_instanties
SBH	overige_instanties
SBIC	overige_instanties
SBW	overige_instanties
SCOSZ	overige_instanties
SEH 	overige_instanties
sepr	overige_instanties
SER	overige_instanties
SF	overige_instanties
SFERD	overige_instanties
SFH	overige_instanties
SFR	overige_instanties
SFV	overige_instanties
SH&M	overige_instanties
SHE	overige_instanties
SIT	overige_instanties
SLA	overige_instanties
slebb	overige_instanties
SMART	overige_instanties
SMR	overige_instanties
SMT	overige_instanties
SMUR	overige_instanties
SNAQ	overige_instanties
SNZ	overige_instanties
SOM	overige_instanties
SPPS	overige_instanties
SRA	overige_instanties
SSCL	overige_instanties
STE	overige_instanties
STEVES	overige_instanties
STIVA	overige_instanties
STZ	overige_instanties
SVB	overige_instanties
SVO	overige_instanties
SVR	overige_instanties
SVS	overige_instanties
SWOT	overige_instanties
SZW	overige_instanties
T&A	overige_instanties
TC	overige_instanties
TD	overige_instanties
TeRM	overige_instanties
THP	overige_instanties
TNCC	overige_instanties
TNO	overige_instanties
TOC	overige_instanties
TOP	overige_instanties
TQM	overige_instanties
tr	overige_instanties
TRALI	overige_instanties
TRES	overige_instanties
TSS	overige_instanties
TTP	overige_instanties
TU	overige_instanties
TUD	overige_instanties
TUE	overige_instanties
TVB	overige_instanties
TZ-OZ	overige_instanties
uDSMH	overige_instanties
UHO	overige_instanties
UHV	overige_instanties
UL	overige_instanties
UM	overige_instanties
UMCG	overige_instanties
UMCN	overige_instanties
UMCU	overige_instanties
UNCTAD	overige_instanties
UNESCO	overige_instanties
UNICEF	overige_instanties
UN-keurmerk	overige_instanties
UT	overige_instanties
UU	overige_instanties
UvA	overige_instanties
UVIT	overige_instanties
UvT	overige_instanties
UWV	overige_instanties
UZ 	overige_instanties
V&V	overige_instanties
V&VN 	overige_instanties
V&W	overige_instanties
VAIO	overige_instanties
VAPRO	overige_instanties
VAR	overige_instanties
VB	overige_instanties
VBBA	overige_instanties
VBH	overige_instanties
VBO	overige_instanties
VBR	overige_instanties
VBS	overige_instanties
VBW	overige_instanties
VC	overige_instanties
VCMO	overige_instanties
VE	overige_instanties
VELO	overige_instanties
VENECA	overige_instanties
VEV	overige_instanties
VGM	overige_instanties
VIM	overige_instanties
Vk	overige_instanties
vmbo	overige_instanties
VMC	overige_instanties
VMP 	overige_instanties
VMR	overige_instanties
VMS	overige_instanties
VN	overige_instanties
VNG	overige_instanties
VNO/NCW	overige_instanties
VNZ	overige_instanties
VO	overige_instanties
VOC	overige_instanties
VOC/BETEX	overige_instanties
VOV	overige_instanties
VROM	overige_instanties
VSHO	overige_instanties
VSV	overige_instanties
VTGM	overige_instanties
VU	overige_instanties
VVA	overige_instanties
VVI	overige_instanties
VVMI	overige_instanties
VVT	overige_instanties
VWO	overige_instanties
VWS	overige_instanties
VZI	overige_instanties
WA	overige_instanties
WAO	overige_instanties
WBD	overige_instanties
WBMV	overige_instanties
WBP	overige_instanties
WCKZ	overige_instanties
WCMS	overige_instanties
WcZ	overige_instanties
wdh	overige_instanties
wdm	overige_instanties
wdv	overige_instanties
WEB	overige_instanties
WEU	overige_instanties
WFZ	overige_instanties
WGBO	overige_instanties
WGO	overige_instanties
WHO	overige_instanties
WIA	overige_instanties
WIBAZ	overige_instanties
WIP	overige_instanties
WIV	overige_instanties
WMCZ	overige_instanties
Wmg	overige_instanties
WMO	overige_instanties
WO	overige_instanties
WOB	overige_instanties
WOR	overige_instanties
WOT	overige_instanties
WRR	overige_instanties
WTO	overige_instanties
WTZi	overige_instanties
WVC	overige_instanties
WVO	overige_instanties
WZC	overige_instanties
XDS	overige_instanties
XSD	overige_instanties
ZBC	overige_instanties
ZER	overige_instanties
ZFR	overige_instanties
ZFW	overige_instanties
ZiROP	overige_instanties
ZIS	overige_instanties
ZIZO	overige_instanties
ZN	overige_instanties
ZonMW	overige_instanties
ZPI	overige_instanties
Zvw	overige_instanties
ZW	overige_instanties
ZZP	overige_instanties
ZZZ	overige_instanties
3RO	wetten
A&O	wetten
AAW	wetten
AB	wetten
ABB	wetten
ABBZ	wetten
ABP	wetten
ABP-wet	wetten
Abw	wetten
AC	wetten
ACOM	wetten
ACOP	wetten
ACP	wetten
AD	wetten
ADo	wetten
ADR	wetten
ADV	wetten
Advw	wetten
AFB	wetten
AFR	wetten
AG	wetten
AGO	wetten
AiO	wetten
AIVD	wetten
AJB	wetten
AKW	wetten
AMvB	wetten
Anw	wetten
AOb	wetten
AOC	wetten
AOW	wetten
APS	wetten
APV	wetten
ARBO	wetten
Arbon	wetten
ARO	wetten
ART	wetten
Artw	wetten
ASV	wetten
ATAN	wetten
ATW	wetten
AUDH	wetten
AVG	wetten
AVO	wetten
AVR	wetten
AVRM	wetten
AVS	wetten
Avw 1996	wetten
AW	wetten
Awb	wetten
AWBZ	wetten
AWDA	wetten
AWF	wetten
AWGB	wetten
AWIR	wetten
Awob	wetten
AWOZ	wetten
AWR	wetten
AWT	wetten
AWVN	wetten
AWW	wetten
AZC's	wetten
B	wetten
BABW	wetten
BAO	wetten
BAPO	wetten
BBBB 1998	wetten
BBI	wetten
BBL	wetten
BBO	wetten
BBP	wetten
BBS	wetten
BBWO	wetten
Belwlv	wetten
Belwp	wetten
Belwv	wetten
Berw	wetten
Besluit OGB	wetten
Besluit OZB	wetten
BEU	wetten
BG	wetten
BGD	wetten
BGG	wetten
BGZ	wetten
BIA	wetten
BIBA	wetten
BIC	wetten
BIG	wetten
binas	wetten
BIO	wetten
BIS	wetten
BiZa	wetten
BJZ	wetten
BK	wetten
BMF	wetten
BMTI	wetten
BMW	wetten
Bmw1962	wetten
BO	wetten
BOA	wetten
BOinK	wetten
BOL	wetten
BOOG	wetten
BOOM	wetten
BOOT	wetten
BOP	wetten
BOPP	wetten
BOPZ	wetten
BOSK	wetten
Bosw	wetten
BPCO	wetten
BPF	wetten
BPR	wetten
Brandww1985	wetten
BRK	wetten
Bro	wetten
BS	wetten
BSD	wetten
BSF	wetten
BSM	wetten
BSN	wetten
BSO	wetten
Btb	wetten
Bte 1995	wetten
BTMW	wetten
BUA	wetten
BUB 1999	wetten
BVA	wetten
Bvdb 2001	wetten
BVE	wetten
BVOM	wetten
BVRB	wetten
BW	wetten
BW (oud)	wetten
BWOO	wetten
BZA	wetten
c.e.	wetten
c.i.e.	wetten
c.s.p.e.	wetten
CABO	wetten
CAD	wetten
CAO	wetten
CAOP	wetten
CASO	wetten
CAT	wetten
CBA	wetten
CBOO	wetten
Cbp	wetten
CBR	wetten
CBS	wetten
CCO	wetten
CCOOP	wetten
CDA	wetten
CDW	wetten
CEB	wetten
CEVO	wetten
CFI	wetten
CGOA	wetten
CIL	wetten
CINOP	wetten
CIO	wetten
CISA	wetten
CITO	wetten
CJIB	wetten
CKV	wetten
CLU	wetten
CMHF	wetten
CNV	wetten
COA	wetten
COB	wetten
COlO	wetten
Colpw	wetten
COMPAS	wetten
Cotan	wetten
COVA	wetten
COVOG	wetten
CPB	wetten
CPG	wetten
CPS	wetten
CPT	wetten
CREBO	wetten
CRI	wetten
Criem	wetten
CROHO	wetten
CRvB	wetten
CSO	wetten
CSV	wetten
CSZP	wetten
CTBP	wetten
CTSV	wetten
CvB	wetten
CVI	wetten
CVS	wetten
CW	wetten
CW 2001	wetten
CWI	wetten
CWP	wetten
D & I	wetten
D 	wetten
DAD	wetten
DBM	wetten
DC	wetten
DCO	wetten
Deltawet	wetten
Destructiewet	wetten
DForZo	wetten
DG	wetten
D-G	wetten
DGO	wetten
DGR	wetten
Dhw	wetten
DIB	wetten
DJI	wetten
DOP II	wetten
DOR	wetten
DPAN	wetten
DPJS	wetten
DPO	wetten
DSP	wetten
DV&O	wetten
DVO	wetten
DW	wetten
EA	wetten
EBG	wetten
EBI	wetten
EC	wetten
ECN	wetten
ED	wetten
EER	wetten
EER-Verdrag	wetten
EFJ	wetten
EFS	wetten
EG	wetten
EGA-Verdrag	wetten
EGKS-Verdrag	wetten
EG-Verdrag	wetten
EI	wetten
EMA	wetten
EMU	wetten
EOV	wetten
EP	wetten
EPA	wetten
EPNO	wetten
EPR	wetten
EPV	wetten
ERW	wetten
ESF	wetten
ESH (herzien)	wetten
ESH 1961	wetten
ESM	wetten
ET	wetten
EU	wetten
EUN	wetten
EU-Verdrag	wetten
EVC	wetten
EVK	wetten
EVO	wetten
EVRM	wetten
EWLW	wetten
EZ	wetten
EZV	wetten
FAOP	wetten
FBS	wetten
Ffw	wetten
FIOD	wetten
Flexwet	wetten
FLO	wetten
FNV	wetten
FOBA	wetten
FPD	wetten
FPU	wetten
FRE	wetten
FSBK	wetten
FSU	wetten
FTE	wetten
FuWa	wetten
FVW	wetten
Fw	wetten
G21	wetten
G4	wetten
GAK	wetten
GBA	wetten
GDW	wetten
GeDeCo	wetten
Gemw	wetten
GENT	wetten
GG&GD	wetten
GGZ	wetten
GION	wetten
GMG	wetten
GMR	wetten
GO	wetten
GOA	wetten
GPL	wetten
GPS	wetten
GSB	wetten
GVO	wetten
Gw	wetten
GWD	wetten
GWW	wetten
HALT	wetten
HAO	wetten
HAS	wetten
HAVO	wetten
HBB	wetten
HBO	wetten
HEAO	wetten
HKS	wetten
HKV 1961	wetten
HKV 1996	wetten
HMR	wetten
Hnw	wetten
HO	wetten
HOI	wetten
HOOP	wetten
HOP	wetten
HPT	wetten
HPW	wetten
Hregw	wetten
HSW	wetten
Huisvw	wetten
HvB	wetten
Hw	wetten
I&A-wet Wft	wetten
Iav	wetten
IBA	wetten
IBBZ	wetten
IBG	wetten
IB-groep	wetten
Ibs	wetten
ICO	wetten
ICT	wetten
ID	wetten
IDO	wetten
IEV	wetten
IFRS	wetten
Ifzo	wetten
IGO	wetten
igvo	wetten
IHP	wetten
IKZ	wetten
ILT	wetten
IND	wetten
IO	wetten
IOBK	wetten
IOO	wetten
IOSV	wetten
IP	wetten
IPB	wetten
IPbw	wetten
IPL	wetten
IRIS	wetten
ISBO	wetten
ISD	wetten
ISO	wetten
ISOVSO	wetten
IST	wetten
IT	wetten
ITP	wetten
ITS	wetten
ITZ	wetten
IVA	wetten
IVBO	wetten
IVBPR 	wetten
IVDV 	wetten
IVESCR	wetten
IVLOS	wetten
IVRD	wetten
IVRK	wetten
IVS	wetten
IW 1990	wetten
IWS	wetten
IZK	wetten
IZS	wetten
JD-Online	wetten
JDS	wetten
JIB	wetten
JJ	wetten
JJI	wetten
JOVO	wetten
JustID	wetten
JVZ	wetten
JW	wetten
JWG	wetten
Kadw	wetten
KAG	wetten
KANS	wetten
KB	wetten
KBB	wetten
KBVO	wetten
KDV	wetten
KEW	wetten
KEZsub	wetten
KG	wetten
KHO	wetten
KIO	wetten
KLNVsub	wetten
KLPD	wetten
KNAW	wetten
KOFS	wetten
KOR	wetten
Kostenwet	wetten
KPC	wetten
KR	wetten
KS	wetten
KSb	wetten
KSe	wetten
KsubVW	wetten
KsuEZ	wetten
KSZWsub	wetten
KUB	wetten
KUN	wetten
KVE	wetten
Kvgsub	wetten
KVLO	wetten
KVV	wetten
Kw	wetten
Kw BIV	wetten
Kw VE 1991	wetten
KWL	wetten
LA	wetten
LAA	wetten
LAB	wetten
LAB 1984	wetten
LABG	wetten
LAKS	wetten
LB	wetten
LBSD	wetten
LBV	wetten
LCIG	wetten
LCW	wetten
LDC	wetten
LdH	wetten
Leidraad BPM	wetten
Leidraad Invordering 1990	wetten
Leidraad MB 1980	wetten
Leidraad RVBI	wetten
LEO	wetten
LEVITA	wetten
LFST	wetten
LGF	wetten
LIO	wetten
Lisv	wetten
LIW	wetten
LIWI	wetten
LKW	wetten
LNA	wetten
LNV	wetten
LOB	wetten
LOPS	wetten
LOW	wetten
LP	wetten
LPW 1969	wetten
LS	wetten
LSOP-wet	wetten
LVR	wetten
LVW	wetten
Lw	wetten
MBV	wetten
Mcp	wetten
MITS	wetten
MK	wetten
MMD'er	wetten
Monw 1988	wetten
MOT	wetten
MPC	wetten
MR	wetten
MST	wetten
Msw	wetten
MvJ	wetten
Mw	wetten
Mw 1903	wetten
NBW	wetten
NB-wet	wetten
NFI	wetten
NIFP	wetten
NOMS	wetten
NSA	wetten
NSW	wetten
NT2	wetten
NU	wetten
NVA	wetten
NVGZ	wetten
NVLF/O	wetten
NVMO	wetten
NVP	wetten
NVvR	wetten
NWO	wetten
NZF	wetten
NZI	wetten
OA	wetten
OAC	wetten
OAD	wetten
OALT	wetten
OB	wetten
OBD	wetten
OBJD	wetten
OBP	wetten
OBU	wetten
OBW	wetten
OCTO	wetten
OCW	wetten
OE2R	wetten
OESO	wetten
OGGZ	wetten
OGO	wetten
OGT	wetten
OH	wetten
OHT	wetten
OiO	wetten
OISOVSO	wetten
OLA	wetten
OLP	wetten
OM	wetten
OMO	wetten
OOP	wetten
Oort-I	wetten
Oort-II	wetten
Oort-III	wetten
OOW	wetten
OP	wetten
OP/NP	wetten
OPDC	wetten
OPS	wetten
Opw	wetten
OR	wetten
ORION	wetten
OROV	wetten
OSV	wetten
OSV 1997	wetten
OTS	wetten
OU	wetten
Ouders&	wetten
OV	wetten
OVB	wetten
OVH	wetten
OvJ	wetten
OW	wetten
OWB	wetten
OWVO	wetten
P(G)MR	wetten
PAB	wetten
PABO	wetten
PaG	wetten
PAGO	wetten
PBW	wetten
PCl	wetten
PEMBA	wetten
PF	wetten
PG	wetten
P-G	wetten
PGA	wetten
PGB	wetten
PGN	wetten
PI	wetten
PIA	wetten
PICT	wetten
PIJ	wetten
PIV	wetten
PIVOT	wetten
PIW	wetten
PKI	wetten
PKW	wetten
PM	wetten
PMPO	wetten
PMR	wetten
PMTK	wetten
PMVO	wetten
PO	wetten
POI	wetten
Polw 1993	wetten
POP	wetten
PP	wetten
PPO	wetten
PPP	wetten
PPS	wetten
PPSI	wetten
Ppw	wetten
PR	wetten
PRA	wetten
Prijzw	wetten
PROGIS	wetten
PROVE	wetten
Provw	wetten
PRW	wetten
PSC	wetten
PSO	wetten
PSW	wetten
PV	wetten
PVE	wetten
PVO	wetten
PVV	wetten
Pw	wetten
QS	wetten
RA	wetten
RAS	wetten
Rb	wetten
RBO	wetten
RC	wetten
RDA	wetten
RDDF	wetten
RdW	wetten
REA	wetten
REC	wetten
Regeling-BHV Financiën	wetten
Ri&e	wetten
RIAGG	wetten
RIO	wetten
RION	wetten
RIP	wetten
RISc	wetten
RM	wetten
RMO	wetten
RO	wetten
ROA	wetten
ROC	wetten
ROP	wetten
ROW 1995	wetten
ROZ	wetten
RPB WPO/	wetten
RPBO	wetten
RSI	wetten
RSJ	wetten
RST	wetten
RSW	wetten
RT	wetten
RTOS	wetten
RTS	wetten
RTW 1936	wetten
RuG	wetten
RUL	wetten
Rv	wetten
RVBI	wetten
RVC	wetten
RvdK	wetten
RvdR	wetten
RvO I	wetten
RvO II	wetten
RvO Ministerraad	wetten
RVV1990	wetten
Rw	wetten
Rw Ned	wetten
RWI	wetten
RWW	wetten
s.g.	wetten
SAD	wetten
SAMOS	wetten
SBAO	wetten
SBD	wetten
SBL	wetten
SBN	wetten
SBO	wetten
SBR	wetten
SCO	wetten
SCOP	wetten
SCOW	wetten
SCP	wetten
SDM	wetten
SDS	wetten
SEJU	wetten
SEP	wetten
SER	wetten
S-G	wetten
SIOD	wetten
SKDB 	wetten
SKN 	wetten
SLO	wetten
SLOA	wetten
SMA	wetten
SO	wetten
SOB	wetten
SOFI	wetten
SOO	wetten
SOP	wetten
SOR	wetten
SOV	wetten
SoZaWe	wetten
SPD	wetten
Spil	wetten
SPIN	wetten
Sr	wetten
SRN	wetten
STAR	wetten
Statuut	wetten
STPD	wetten
STRABIS	wetten
SUBS	wetten
SUK	wetten
SUWI	wetten
Sv	wetten
SVB	wetten
SVG	wetten
SVL	wetten
SVM	wetten
SVO	wetten
SW 1956	wetten
SWI	wetten
swv	wetten
SZ	wetten
SZW	wetten
T&B	wetten
TA	wetten
TAD	wetten
TAV	wetten
TBA	wetten
TBS	wetten
TCDW	wetten
TCIO	wetten
TCOMW	wetten
TLZ	wetten
TMF	wetten
TOA	wetten
TOBIAS	wetten
TOG 2000	wetten
TOV	wetten
Tra	wetten
Tracéwet	wetten
TSEL	wetten
TULP	wetten
TULP/JJI	wetten
TVPM	wetten
TVS	wetten
TW	wetten
TWAO	wetten
TwK	wetten
TZ	wetten
UAR 1986	wetten
UAR 2001	wetten
UG/l	wetten
Uitv.besch.	wetten
Uitv.besch. LB 1965	wetten
Uitv.besl. 	wetten
Uitv.reg. 	wetten
ULO	wetten
UNESCO	wetten
USB	wetten
USZO	wetten
UvA	wetten
uvi	wetten
UVRM	wetten
UW	wetten
UWV	wetten
VAB 1993	wetten
VAVO	wetten
VBA	wetten
VBKO	wetten
VBO	wetten
VBS	wetten
VE	wetten
VEBOSS	wetten
VELO	wetten
VEV	wetten
VF	wetten
VFZ	wetten
VGW	wetten
VH	wetten
VHI	wetten
VI	wetten
VIM	wetten
VIP	wetten
VLBV	wetten
VLS	wetten
VLWP	wetten
VMBO	wetten
VMR	wetten
VN	wetten
VNG	wetten
VNN	wetten
VNO-NCW	wetten
VO	wetten
VOG	wetten
VOLG	wetten
VOO	wetten
VOS/ABB	wetten
VPS	wetten
VR	wetten
VRL	wetten
VRO	wetten
VROS	wetten
VSD	wetten
VSNU	wetten
VSO	wetten
VSV	wetten
VSWO	wetten
VU	wetten
VUN	wetten
VUT	wetten
VVE	wetten
VVO	wetten
VVVO	wetten
VW	wetten
VW 2000	wetten
VWJ	wetten
VWO	wetten
VWS	wetten
W WAA	wetten
WA	wetten
Waadi	wetten
WAB	wetten
Wabb	wetten
Wabm	wetten
Wabo	wetten
WAG	wetten
WAGW	wetten
WAHV	wetten
Wajong	wetten
Wak	wetten
WAM	wetten
Wamil	wetten
WAO	wetten
Waots	wetten
Warenw	wetten
WAUOO	wetten
Wav	wetten
Waz	wetten
WAZO	wetten
WBa	wetten
Wbb	wetten
Wbbo	wetten
WBEAA	wetten
Wbm	wetten
WBO	wetten
Wbp	wetten
WBPZ	wetten
WBR	wetten
WBSO	wetten
Wca	wetten
WCBO	wetten
WCE	wetten
WCH	wetten
WCHb	wetten
WCHr	wetten
WCK	wetten
WCN	wetten
WD	wetten
WEB	wetten
WEBA	wetten
WEBO	wetten
WEC	wetten
WED	wetten
WEO	wetten
WEOS	wetten
Wet AA	wetten
Wet AB	wetten
Wet ARB	wetten
Wet ARGI	wetten
Wet ARHI	wetten
Wet AROB	wetten
Wet AVV	wetten
Wet BAB	wetten
Wet BEU	wetten
Wet BIBOB	wetten
Wet BIG	wetten
Wet BIO	wetten
Wet BO	wetten
Wet Bopz	wetten
Wet Bpf 2000	wetten
Wet BPM	wetten
Wet BZM	wetten
Wet CAO	wetten
Wet COOA	wetten
Wet CPV	wetten
Wet DB 1965	wetten
Wet EOR	wetten
Wet Fes	wetten
Wet GBA	wetten
Wet IB 1964	wetten
Wet IB 2001	wetten
Wet IHS	wetten
Wet IOAW	wetten
Wet IOAZ	wetten
Wet KvK 1997	wetten
Wet LB 1964	wetten
Wet LBIO	wetten
Wet LUVO	wetten
Wet LV	wetten
Wet MB 1966	wetten
Wet MB 1994	wetten
Wet MOOZ	wetten
Wet MOT	wetten
Wet OB 1954	wetten
Wet OB 1968	wetten
Wet Pemba	wetten
Wet PMA	wetten
Wet RA	wetten
Wet REA	wetten
Wet RO	wetten
Wet RvS	wetten
Wet SUWI	wetten
Wet SVB	wetten
Wet SVB/RvA	wetten
Wet TBA	wetten
Wet TZ	wetten
Wet VB 1964	wetten
Wet VPB 1969	wetten
Wet WOZ	wetten
WETS	wetten
WEU	wetten
WEV	wetten
WFBB 1994	wetten
Wflo	wetten
Wfsv	wetten
Wft	wetten
WFV	wetten
WFVP	wetten
WGB	wetten
WGBH/CZ	wetten
WGBL	wetten
WGBO	wetten
Wge	wetten
WGH	wetten
WGHR	wetten
WGO	wetten
WGR	wetten
WGW	wetten
Wgzhvvv	wetten
WHBO	wetten
WHC	wetten
Wht	wetten
Whvarkh	wetten
Whvz	wetten
WHW	wetten
WIA	wetten
WIB	wetten
WID	wetten
Wif	wetten
WIF 1993	wetten
Wik	wetten
WIN	wetten
WINW	wetten
WIR	wetten
WIV	wetten
WIVD	wetten
WIVD 2002	wetten
WIW	wetten
WJG	wetten
WJHV	wetten
WJSG	wetten
WKa	wetten
WLOM	wetten
WLv	wetten
WLW	wetten
WMB	wetten
WMCO	wetten
WML	wetten
Wmo	wetten
Wms	wetten
Wmz 1996	wetten
WN	wetten
Wna	wetten
WNo	wetten
WNR	wetten
WO	wetten
WOA	wetten
WOB	wetten
Wobka	wetten
WOBP	wetten
WOCZ	wetten
WODC	wetten
WOG	wetten
WOHV	wetten
WoK	wetten
WOM	wetten
Wonw	wetten
Woo	wetten
WOR	wetten
WOTS	wetten
WOU	wetten
WOV	wetten
WPA	wetten
WPE	wetten
WPO	wetten
WPOLr	wetten
WPR	wetten
WPRO	wetten
WPV 2000	wetten
WRB	wetten
Wrbs	wetten
WRfv	wetten
WRM1993	wetten
WRO	wetten
WRR	wetten
Wrra	wetten
WS	wetten
Wsc	wetten
Wschw	wetten
WSDV	wetten
WSF	wetten
WSF 2000	wetten
Wsnp	wetten
WSNS	wetten
Wsw	wetten
WTB	wetten
WTBZ	wetten
Wte 1995	wetten
Wtfv	wetten
WTG	wetten
Wtk 1992	wetten
WTN	wetten
WTOS	wetten
WTS	wetten
WTSZ	wetten
WTVb 1993	wetten
WTW	wetten
WTZ	wetten
WTZ 1998	wetten
WUBO	wetten
Wulbz	wetten
WUV	wetten
WVA	wetten
WVB	wetten
WVG	wetten
WVGem	wetten
WVGS	wetten
WVGZ	wetten
WvK	wetten
Wvmp	wetten
WvMS	wetten
WVO	wetten
WVOI	wetten
WVOP	wetten
WVP	wetten
WvPO	wetten
WVR	wetten
WvSr	wetten
WvSv	wetten
WVV	wetten
WVVS	wetten
WVW	wetten
WVW 1994	wetten
Wvz	wetten
WW	wetten
WW 1994	wetten
WWB	wetten
WWH	wetten
WWM	wetten
WWO	wetten
WWV	wetten
WZV	wetten
ZBBI	wetten
ZBO	wetten
ZFB	wetten
ZFR	wetten
ZFW	wetten
ZH	wetten
ZKOO	wetten
ZM	wetten
ZMLK	wetten
ZMOK	wetten
ZPW	wetten
ZVO	wetten
Zvw	wetten
ZVWOV	wetten
ZW	wetten
AQUA	wetten
ARG 	wetten
CB	wetten
CC	wetten
CCI 	wetten
CCRA 	wetten
DACAN 	wetten
DVI	wetten
GD	wetten
IATO 	wetten
ICT 	wetten
ITSEC 	wetten
KVM 	wetten
NAVO 	wetten
NATO	wetten
NBV	wetten
NCSA 	wetten
NDA 	wetten
NLNDA 	wetten
NLNCSA 	wetten
NSCIB 	wetten
OD	wetten
ROC 	wetten
SECAN 	wetten
SG 	wetten
(S)VGA	wetten
USB 	wetten
VGA	wetten
Vir	wetten
Vir-bi	wetten
Vir-gi	wetten
VBV	wetten
WBI	wetten
H 	chemie
Li 	chemie
Be 	chemie
Na 	chemie
Mg 	chemie
K 	chemie
Ca 	chemie
Sc 	chemie
Ti 	chemie
V 	chemie
Cr 	chemie
Mn 	chemie
Fe 	chemie
Rb 	chemie
Sr 	chemie
Y 	chemie
Zr 	chemie
Nb 	chemie
Mo 	chemie
Tc 	chemie
Ru 	chemie
Cs 	chemie
Ba 	chemie
La 	chemie
Hf 	chemie
Ta 	chemie
W 	chemie
Re 	chemie
Os 	chemie
He 	chemie
B 	chemie
C 	chemie
N 	chemie
O 	chemie
F 	chemie
Ne 	chemie
Al 	chemie
Si 	chemie
P 	chemie
S 	chemie
Cl 	chemie
Ar 	chemie
Co 	chemie
Ni 	chemie
Cu 	chemie
Zn 	chemie
Ga 	chemie
Ge 	chemie
As 	chemie
Se 	chemie
Br 	chemie
Kr 	chemie
Rh 	chemie
Pd 	chemie
Ag 	chemie
Cd 	chemie
In 	chemie
Sn 	chemie
Sb 	chemie
Te 	chemie
I 	chemie
Xe 	chemie
Ir 	chemie
Pt 	chemie
Au 	chemie
Hg 	chemie
Tl 	chemie
Pb 	chemie
Bi 	chemie
Po 	chemie
At 	chemie
Rn 	chemie
Mt 	chemie
Fr 	chemie
Ra 	chemie
Ac 	chemie
Rf 	chemie
Db 	chemie
Sg 	chemie
Bh 	chemie
Hs 	chemie
Ce 	chemie
Pr 	chemie
Nd 	chemie
Pm 	chemie
Th 	chemie
Pa 	chemie
U 	chemie
Np 	chemie
Sm 	chemie
Eu 	chemie
Gd 	chemie
Tb 	chemie
Dy 	chemie
Ho 	chemie
Er 	chemie
Tm 	chemie
Yb 	chemie
Lu 	chemie
Pu 	chemie
Am 	chemie
Cm 	chemie
Bk 	chemie
Cf 	chemie
Es 	chemie
Fm 	chemie
Md 	chemie
No 	chemie
Lr 	chemie
AT5	omroepen
at5	omroepen
AVRO	omroepen
b.b.c.	omroepen
b.n.r.	omroepen
BBC	omroepen
BNN	omroepen
BNR	omroepen
BOS	omroepen
C.N.N.	omroepen
CNN	omroepen
EO	omroepen
IKON	omroepen
JO	omroepen
KRO	omroepen
MAX	omroepen
NCRV	omroepen
NOS	omroepen
NTR	omroepen
OF	omroepen
PowNed	omroepen
PP	omroepen
RKK	omroepen
RTL	omroepen
SBS	omroepen
SZM	omroepen
TROS	omroepen
VARA	omroepen
VPRO	omroepen
WNL	omroepen
ZvK	omroepen
AC	politie_ziekenhuis
ACB	politie_ziekenhuis
ACBev	politie_ziekenhuis
ACBz	politie_ziekenhuis
AGS	politie_ziekenhuis
AIBV	politie_ziekenhuis
AMvB	politie_ziekenhuis
AOR	politie_ziekenhuis
Arb	politie_ziekenhuis
ATb	politie_ziekenhuis
AZN	politie_ziekenhuis
B&W	politie_ziekenhuis
BAG	politie_ziekenhuis
BC	politie_ziekenhuis
BDUR	politie_ziekenhuis
BGM	politie_ziekenhuis
BGT	politie_ziekenhuis
BLEVE	politie_ziekenhuis
BM	politie_ziekenhuis
BOB	politie_ziekenhuis
BOS	politie_ziekenhuis
BOT	politie_ziekenhuis
BRIL	politie_ziekenhuis
BRK	politie_ziekenhuis
BRT	politie_ziekenhuis
BRW	politie_ziekenhuis
BRZO	politie_ziekenhuis
BSH	politie_ziekenhuis
BT	politie_ziekenhuis
BVIM	politie_ziekenhuis
Bvr	politie_ziekenhuis
BWC	politie_ziekenhuis
CaCo	politie_ziekenhuis
CBRN	politie_ziekenhuis
CCB	politie_ziekenhuis
CCO	politie_ziekenhuis
CdK,CvdK	politie_ziekenhuis
CGV	politie_ziekenhuis
CIb	politie_ziekenhuis
CMBA	politie_ziekenhuis
CMK	politie_ziekenhuis
CMS	politie_ziekenhuis
CoPI	politie_ziekenhuis
COSI	politie_ziekenhuis
CRAS	politie_ziekenhuis
CRIB	politie_ziekenhuis
CRT	politie_ziekenhuis
CvD	politie_ziekenhuis
CvD-G	politie_ziekenhuis
DCC	politie_ziekenhuis
DCMR	politie_ziekenhuis
DTN	politie_ziekenhuis
DURP	politie_ziekenhuis
ECDC	politie_ziekenhuis
ERC	politie_ziekenhuis
ERIC	politie_ziekenhuis
GAC	politie_ziekenhuis
GAGS	politie_ziekenhuis
GBA	politie_ziekenhuis
GBKN	politie_ziekenhuis
GBO	politie_ziekenhuis
GBT	politie_ziekenhuis
GCC	politie_ziekenhuis
GGZ	politie_ziekenhuis
GMS	politie_ziekenhuis
GMT	politie_ziekenhuis
GN	politie_ziekenhuis
GNK	politie_ziekenhuis
GNK-C	politie_ziekenhuis
GRIP	politie_ziekenhuis
GROP	politie_ziekenhuis
GRS	politie_ziekenhuis
GS	politie_ziekenhuis
GSP	politie_ziekenhuis
Hac	politie_ziekenhuis
HGN	politie_ziekenhuis
HMIMS	politie_ziekenhuis
HOvD	politie_ziekenhuis
HOvJ	politie_ziekenhuis
HS-Gem	politie_ziekenhuis
HS-GHOR	politie_ziekenhuis
HTo	politie_ziekenhuis
IAC	politie_ziekenhuis
IASV	politie_ziekenhuis
IBBT	politie_ziekenhuis
IBV	politie_ziekenhuis
ICMS	politie_ziekenhuis
i-DBK	politie_ziekenhuis
IM	politie_ziekenhuis
IOOV	politie_ziekenhuis
IPO	politie_ziekenhuis
IVM	politie_ziekenhuis
JBZ	politie_ziekenhuis
KLPD	politie_ziekenhuis
KLu	politie_ziekenhuis
Kmar	politie_ziekenhuis
KNBRD	politie_ziekenhuis
KNRM	politie_ziekenhuis
KWC	politie_ziekenhuis
LARA	politie_ziekenhuis
LBCB	politie_ziekenhuis
LCI	politie_ziekenhuis
LCMS	politie_ziekenhuis
LOCC	politie_ziekenhuis
LOS	politie_ziekenhuis
LP	politie_ziekenhuis
LTFO	politie_ziekenhuis
MBC	politie_ziekenhuis
MBT	politie_ziekenhuis
MCDM	politie_ziekenhuis
MCPM	politie_ziekenhuis
MDT	politie_ziekenhuis
ME	politie_ziekenhuis
MIA-V	politie_ziekenhuis
MK	politie_ziekenhuis
MKA	politie_ziekenhuis
MKB	politie_ziekenhuis
MMA	politie_ziekenhuis
NA-OOV	politie_ziekenhuis
Natres	politie_ziekenhuis
NAVI	politie_ziekenhuis
Nbbe	politie_ziekenhuis
NCC	politie_ziekenhuis
NCSS	politie_ziekenhuis
NCTb	politie_ziekenhuis
NCTV	politie_ziekenhuis
NCV	politie_ziekenhuis
NCW	politie_ziekenhuis
NHG	politie_ziekenhuis
NIFVNibra	politie_ziekenhuis
NN	politie_ziekenhuis
NORAr	politie_ziekenhuis
NRB	politie_ziekenhuis
NRK	politie_ziekenhuis
NS	politie_ziekenhuis
NUP	politie_ziekenhuis
NVBR	politie_ziekenhuis
NVC	politie_ziekenhuis
OGS	politie_ziekenhuis
OL	politie_ziekenhuis
OOV	politie_ziekenhuis
OvD	politie_ziekenhuis
OvD-B	politie_ziekenhuis
OvD-Bz	politie_ziekenhuis
OvD-G	politie_ziekenhuis
OvD-P	politie_ziekenhuis
OvJ	politie_ziekenhuis
OvV	politie_ziekenhuis
PMK	politie_ziekenhuis
POG	politie_ziekenhuis
PSH	politie_ziekenhuis
PSHOR	politie_ziekenhuis
PTSS	politie_ziekenhuis
RAC	politie_ziekenhuis
RAV	politie_ziekenhuis
RBT	politie_ziekenhuis
RCC	politie_ziekenhuis
RCvD	politie_ziekenhuis
RGF	politie_ziekenhuis
RIT	politie_ziekenhuis
RMK	politie_ziekenhuis
ROT	politie_ziekenhuis
RRCP	politie_ziekenhuis
RWS	politie_ziekenhuis
SAR	politie_ziekenhuis
SHN	politie_ziekenhuis
SIGMA	politie_ziekenhuis
Sitrap	politie_ziekenhuis
SMH	politie_ziekenhuis
TAS	politie_ziekenhuis
TGBM	politie_ziekenhuis
TIS	politie_ziekenhuis
TK	politie_ziekenhuis
TL	politie_ziekenhuis
TMO	politie_ziekenhuis
UGS	politie_ziekenhuis
VAA	politie_ziekenhuis
VBV	politie_ziekenhuis
VORAMP	politie_ziekenhuis
VRBZO	politie_ziekenhuis
VRR	politie_ziekenhuis
VRU	politie_ziekenhuis
VtSPN	politie_ziekenhuis
VWA	politie_ziekenhuis
WRZO	politie_ziekenhuis
WVD	politie_ziekenhuis
Wvr	politie_ziekenhuis
a.s.	generiek
a.u.b.	generiek
afd.	generiek
afz.	generiek
b.g.g.	generiek
bv.	generiek
c.c.	generiek
c.g.	generiek
ca.	generiek
d.d.	generiek
d.m.v.	generiek
d.w.z.	generiek
dhr.	generiek
Dr.	generiek
e.a.	generiek
e.d.	generiek
e.e.a.	generiek
e.k.	generiek
enz.	generiek
etc.	generiek
ev.	generiek
ex.	generiek
excl.	generiek
i.o.v.	generiek
i.p.v.	generiek
i.s.m.	generiek
i.v.m.	generiek
i.z.g.st.	generiek
id.	generiek
incl.	generiek
jl.	generiek
ll.	generiek
m.a.w.	generiek
m.b.t.	generiek
m.i.	generiek
m.i.v.	generiek
m.m.v.	generiek
m.n.	generiek
m.u.v.	generiek
mevr.	generiek
mr.	generiek
mw.	generiek
n.a.v.	generiek
n.m.	generiek
n.n.b.	generiek
n.o.t.k.	generiek
n.t.b.	generiek
n.v.t.	generiek
nl.	generiek
nr.	generiek
o.a.	generiek
o.g.	generiek
o.i.	generiek
p.a.	generiek
p.d.	generiek
p.o.	generiek
p.p.	generiek
p.s	generiek
P.S.	generiek
p.w.	generiek
prof.	generiek
s.v.p.	generiek
t.a.v.	generiek
t.b.v.	generiek
t.g.v.	generiek
t.n.v.	generiek
t.o.v.	generiek
t.z.t.	generiek
t/m	generiek
v.l.n.r.	generiek
v.v.	generiek
vlg.	generiek
vnl.	generiek
z.g.a.n.	generiek
z.i.	generiek
z.o.z.	generiek
z.s.m.	generiek
zgn.	generiek
