aanbevelenswaard	adjectief
aanbevelenswaardig	adjectief
aanbiddelijk	adjectief
aangenaam	adjectief
aanlokkelijk	adjectief
aanmatigend	adjectief
aanmerkelijk	adjectief
aannemelijk	adjectief
aanstootgevend	adjectief
aanvankelijk	adjectief
aanvechtbaar	adjectief
aanzienlijk	adjectief
abject	adjectief
abominabel	adjectief
abrupt	adjectief
absurd	adjectief
abuis	adjectief
abusievelijk	adjectief
acceptabel	adjectief
accuraat	adjectief
achtenswaard	adjectief
achtenswaardig	adjectief
acuut	adjectief
additioneel	adjectief
adequaat	adjectief
affirmatief	adjectief
afgunstig	adjectief
afgunstwekkend	adjectief
afhandig	adjectief
afkeurenswaardig	adjectief
afschrikwekkend	adjectief
afzichtelijk	adjectief
ambigu	adjectief
ambivalent	adjectief
amicaal	adjectief
ampel	adjectief
amusant	adjectief
analoog	adjectief
angstwekkend	adjectief
antipathiek	adjectief
apocrief	adjectief
armzalig	adjectief
artificieel	adjectief
assertief	adjectief
authentiek	adjectief
autonoom	adjectief
badinerend	adjectief
banaal	adjectief
basaal	adjectief
bedroefd	adjectief
beducht	adjectief
begerenswaardig	adjectief
behartigenswaardig	adjectief
behept met	adjectief
beklagenswaardig	adjectief
bekoorlijk	adjectief
belangwekkend	adjectief
benijdenswaardig	adjectief
benodigd	adjectief
bepaald	adjectief
beschermwaardig	adjectief
beschroomd	adjectief
betreurenswaardig	adjectief
betwistbaar	adjectief
bevredigend	adjectief
bewonderenswaardig	adjectief
bezienswaardig	adjectief
bezoldigd	adjectief
bibliofiel	adjectief
bijkomstig	adjectief
bilateraal	adjectief
billijk	adjectief
blijmoedig	adjectief
bonafide	adjectief
bovenbedoeld	adjectief
bovengenoemd	adjectief
bovenstaand	adjectief
bovenvermeld	adjectief
brisant	adjectief
buitengewoon	adjectief
capabel	adjectief
catastrofaal	adjectief
categorisch	adjectief
ceremonieel	adjectief
chantabel	adjectief
charismatisch	adjectief
choquant	adjectief
clement	adjectief
comfortabel	adjectief
compatibel	adjectief
competent	adjectief
complementair	adjectief
complex	adjectief
compulsief	adjectief
confidentieel	adjectief
congruent	adjectief
consciëntieus	adjectief
consistent	adjectief
consultatief	adjectief
contemplatief	adjectief
conventioneel	adjectief
copieus	adjectief
corpulent	adjectief
correct	adjectief
coulant	adjectief
courant	adjectief
cruciaal	adjectief
cumulatief	adjectief
curieus	adjectief
decentraal	adjectief
declarabel	adjectief
deerniswaardig	adjectief
deerniswekkend	adjectief
delicaat	adjectief
denigrerend	adjectief
desastreus	adjectief
desbetreffend	adjectief
desolaat	adjectief
destructief	adjectief
deugdelijk	adjectief
devoot	adjectief
diffuus	adjectief
dilettant	adjectief
discontinu	adjectief
discriminatoir	adjectief
discutabel	adjectief
disputabel	adjectief
dissonant	adjectief
dogmatisch	adjectief
doorslaggevend	adjectief
draconisch	adjectief
droevig	adjectief
dubieus	adjectief
duizelingwekkend	adjectief
dweepziek	adjectief
educatief	adjectief
eenvoudig	adjectief
eerbiedwaardig	adjectief
electoraal	adjectief
elementair	adjectief
eloquent	adjectief
eminent	adjectief
empathisch	adjectief
enigmatisch	adjectief
equivalent	adjectief
erbarmelijk	adjectief
ergerniswekkend	adjectief
erkentelijk	adjectief
erotisch	adjectief
erudiet	adjectief
essentieel	adjectief
euforisch	adjectief
evident	adjectief
excellent	adjectief
excentriek	adjectief
exceptioneel	adjectief
excessief	adjectief
excusabel	adjectief
exemplarisch	adjectief
exorbitant	adjectief
expliciet	adjectief
exploitabel	adjectief
extatisch	adjectief
extravagant	adjectief
exuberant	adjectief
facturabel	adjectief
fascinerend	adjectief
feeëriek	adjectief
feilbaar	adjectief
feilloos	adjectief
feitelijk	adjectief
fenomenaal	adjectief
fictief	adjectief
fiduciair	adjectief
flagrant	adjectief
flamboyant	adjectief
flegmatiek	adjectief
florissant	adjectief
fnuikend	adjectief
formidabel	adjectief
fotogeniek	adjectief
fraai	adjectief
fragiel	adjectief
fragmentarisch	adjectief
frappant	adjectief
frivool	adjectief
frustatoir	adjectief
functioneel	adjectief
fundamenteel	adjectief
furieus	adjectief
futiel	adjectief
garant	adjectief
geagiteerd	adjectief
gecompliceerd	adjectief
gedegen	adjectief
gedenkwaardig	adjectief
geëigend	adjectief
geestdriftig	adjectief
gegrond	adjectief
geïndigneerd	adjectief
geïnvolveerd	adjectief
gekant	adjectief
gelijkluidend	adjectief
gelijktijdig	adjectief
gelijkwaardig	adjectief
gemeenzaam	adjectief
gemêleerd	adjectief
gemoeid	adjectief
genoeglijk	adjectief
geraffineerd	adjectief
gereed	adjectief
gerieflijk	adjectief
geringschattend	adjectief
goedgeluimd	adjectief
gracieus	adjectief
hachelijk	adjectief
harmonieus	adjectief
hartstochtelijk	adjectief
hautain	adjectief
haveloos	adjectief
hedonisch	adjectief
hedonistisch	adjectief
heilzaam	adjectief
hermetisch	adjectief
heroïsch	adjectief
heterogeen	adjectief
heuglijk	adjectief
homogeen	adjectief
honorabel	adjectief
hooghartig	adjectief
hoogmoedig	adjectief
hovaardig	adjectief
huidig	adjectief
huiveringwekkend	adjectief
humaan	adjectief
hypersensitief	adjectief
identiek	adjectief
idyllisch	adjectief
ijzingwekkend	adjectief
illegitiem	adjectief
illusoir	adjectief
impertinent	adjectief
implausibel	adjectief
impliciet	adjectief
imposant	adjectief
impraktikabel	adjectief
inacceptabel	adjectief
inaccuraat	adjectief
inadequaat	adjectief
incapabel	adjectief
incidenteel	adjectief
incognito	adjectief
incompatibel	adjectief
incompetent	adjectief
incongruent	adjectief
inconsistent	adjectief
inconveniënt	adjectief
incorrect	adjectief
incourant	adjectief
inculpabel	adjectief
infaam	adjectief
inferieur	adjectief
informeel	adjectief
ingetogen	adjectief
inhumaan	adjectief
initieel	adjectief
inofficieel	adjectief
instabiel	adjectief
instrumenteel	adjectief
integer	adjectief
integraal	adjectief
interpretabel	adjectief
intrigerend	adjectief
inzichtelijk	adjectief
inzichtgevend	adjectief
ironisch	adjectief
irrationeel	adjectief
irreëel	adjectief
irrelevant	adjectief
irritabel	adjectief
kennisname	adjectief
klaarblijkelijk	adjectief
kwalijk	adjectief
kwalitatief	adjectief
kwantitatief	adjectief
kwestieus	adjectief
laaghartig	adjectief
laatdunkend	adjectief
labiel	adjectief
laborieus	adjectief
lachwekkend	adjectief
lamentabel	adjectief
langjarig	adjectief
lankmoedig	adjectief
lapidair	adjectief
larmoyant	adjectief
legio	adjectief
legitiem	adjectief
lezenswaard	adjectief
lezenswaardig	adjectief
lichtvaardig	adjectief
lofwaardig	adjectief
lovenswaardig	adjectief
lucullisch	adjectief
ludiek	adjectief
lumineus	adjectief
lustopwekkend	adjectief
luxueus	adjectief
macaber	adjectief
manifest	adjectief
marginaal	adjectief
markant	adjectief
matineus	adjectief
meelijwekkend	adjectief
megalomaan	adjectief
melancholiek	adjectief
meldenswaardig	adjectief
melodramatisch	adjectief
memorabel	adjectief
metaforisch	adjectief
methodisch	adjectief
meticuleus	adjectief
minachtend	adjectief
minuscuul	adjectief
minutieus	adjectief
minzaam	adjectief
moedwillig	adjectief
monomaan	adjectief
monter	adjectief
multi-interpretabel	adjectief
nader	adjectief
naïef	adjectief
nastrevenswaardig	adjectief
navenant	adjectief
navolgende	adjectief
navolgenswaardig	adjectief
navrant	adjectief
neerbuigend	adjectief
netelig	adjectief
nodeloos	adjectief
noemenswaard	adjectief
noemenswaardig	adjectief
noest	adjectief
noodlottig	adjectief
noodzakelijk	adjectief
notoir	adjectief
obsceen	adjectief
obstinaat	adjectief
officieus	adjectief
omineus	adjectief
omstandig	adjectief
omvangrijk	adjectief
onaangenaam	adjectief
onaanlokkelijk	adjectief
onaannemelijk	adjectief
onaantastbaar	adjectief
onaanvaardbaar	adjectief
onaanvechtbaar	adjectief
onaanzienlijk	adjectief
onacceptabel	adjectief
onafwendbaar	adjectief
onbaatzuchtig	adjectief
onbeduidend	adjectief
onberispelijk	adjectief
onbevredigend	adjectief
onbezoldigd	adjectief
onbuigzaam	adjectief
oncomfortabel	adjectief
onderhavig	adjectief
onderhavige	adjectief
onderhevig	adjectief
onderhoudend	adjectief
ondiplomatiek	adjectief
ongecompliceerd	adjectief
ongeëigend	adjectief
ongegeneerd	adjectief
ongegrond	adjectief
ongelijkwaardig	adjectief
ongeloofwaardig	adjectief
ongemoeid	adjectief
ongerieflijk	adjectief
onherroepelijk	adjectief
onjuist	adjectief
onontkoombaar	adjectief
onooglijk	adjectief
onplezierig	adjectief
onreglementair	adjectief
onrendabel	adjectief
onrustbarend	adjectief
onrustwekkend	adjectief
onsystematisch	adjectief
ontdaan	adjectief
ontheemd	adjectief
onthutsend	adjectief
onthutst	adjectief
ontluisterend	adjectief
ontoelaatbaar	adjectief
ontredderd	adjectief
ontsteld	adjectief
ontstemd	adjectief
ontstentenis	adjectief
ontstijgen	adjectief
ontvankelijk	adjectief
ontzagwekkend	adjectief
ontzet	adjectief
onverdienstelijk	adjectief
onverlet	adjectief
onverschrokken	adjectief
onwelriekend	adjectief
onwelvoeglijk	adjectief
onwillekeurig	adjectief
opgetogen	adjectief
opmerkenswaard	adjectief
opmerkenswaardig	adjectief
opportuun	adjectief
optimaal	adjectief
optioneel	adjectief
palliatief	adjectief
partieel	adjectief
passioneel	adjectief
pathetisch	adjectief
pedagogisch	adjectief
pedant	adjectief
perifeer	adjectief
periodiek	adjectief
permissief	adjectief
pernicieus	adjectief
pertinent	adjectief
pittoresk	adjectief
plausibel	adjectief
plezant	adjectief
plezierig	adjectief
polemisch	adjectief
polyinterpretabel	adjectief
pompeus	adjectief
potentieel	adjectief
pover	adjectief
pragmatisch	adjectief
praktikabel	adjectief
pregnant	adjectief
prematuur	adjectief
prestigieus	adjectief
pretentieus	adjectief
prijzenswaardig	adjectief
primair	adjectief
proactief	adjectief
probaat	adjectief
procedureel	adjectief
profitabel	adjectief
prominent	adjectief
proportioneel	adjectief
provisorisch	adjectief
provocatief	adjectief
publicabel	adjectief
pueriel	adjectief
rancuneus	adjectief
rationeel	adjectief
reactief	adjectief
recent	adjectief
rechtschapen	adjectief
redundant	adjectief
reglementair	adjectief
regulier	adjectief
relevant	adjectief
reparabel	adjectief
resoluut	adjectief
respectievelijk	adjectief
restant	adjectief
richtinggevend	adjectief
ridicuul	adjectief
rigide	adjectief
risicovol	adjectief
robuust	adjectief
routineus	adjectief
rustiek	adjectief
saillant	adjectief
sceptisch	adjectief
schamel	adjectief
schrikwekkend	adjectief
seculier	adjectief
secundair	adjectief
sensitief	adjectief
separaat	adjectief
significant	adjectief
slaapverwekkend	adjectief
smartelijk	adjectief
sober	adjectief
sociabel	adjectief
solitair	adjectief
specifiek	adjectief
spoedig	adjectief
sporadisch	adjectief
stoïcijns	adjectief
stringent	adjectief
structureel	adjectief
subiet	adjectief
suboptimaal	adjectief
subsidiabel	adjectief
substantieel	adjectief
subtiel	adjectief
succesievelijk	adjectief
summier	adjectief
superieur	adjectief
symbolisch	adjectief
systematisch	adjectief
talloos	adjectief
telegeniek	adjectief
tendentieus	adjectief
tentatief	adjectief
tijdig	adjectief
tiranniek	adjectief
toonaangevend	adjectief
transparant	adjectief
transportabel	adjectief
triomfantelijk	adjectief
triviaal	adjectief
turbulent	adjectief
uitdrukkelijk	adjectief
uitverkoren	adjectief
universeel	adjectief
urgent	adjectief
vacant	adjectief
valabel	adjectief
vanzelfsprekend	adjectief
variabel	adjectief
veelvoudig	adjectief
veelvuldig	adjectief
verachtelijk	adjectief
verbazingwekkend	adjectief
verbijsterd	adjectief
verbijsterend	adjectief
verbolgen	adjectief
verbouwereerd	adjectief
verderfelijk	adjectief
verdienstelijk	adjectief
verdorven	adjectief
vergevingsgezind	adjectief
verheugd	adjectief
vermakelijk	adjectief
vermeend	adjectief
vermeldenswaard	adjectief
vermeldenswaardig	adjectief
verrukt	adjectief
verwerpelijk	adjectief
vigerend	adjectief
vigilant	adjectief
viriel	adjectief
visionair	adjectief
volgtijdelijk	adjectief
voorafgaand	adjectief
voorhanden	adjectief
voorliggende	adjectief
voormalig	adjectief
voormelde	adjectief
voornoemde	adjectief
voortreffelijk	adjectief
vorenomschreven	adjectief
vorenstaande	adjectief
vreugdeloos	adjectief
vreugdevol	adjectief
vulgair	adjectief
wanstaltig	adjectief
weerzinwekkend	adjectief
weigerachtig	adjectief
welgemoed	adjectief
welriekend	adjectief
wetenswaard	adjectief
wetenswaardig	adjectief
wijlen	adjectief
willekeurig	adjectief
wispelturig	adjectief
woonachtig	adjectief
zorgwekkend	adjectief
c.q.	afkorting
c.s.	afkorting
d.w.z.	afkorting
aanstonds	bijwoord
achtereenvolgens	bijwoord
aldaar	bijwoord
aldanniet	bijwoord
aldra	bijwoord
aldus	bijwoord
allengs	bijwoord
allesbehalve	bijwoord
allicht	bijwoord
alom	bijwoord
alsdan	bijwoord
alstoen	bijwoord
althans	bijwoord
ambtshalve	bijwoord
andermaal	bijwoord
anderszins	bijwoord
anderzijds	bijwoord
beduidend	bijwoord
beleefdheidshalve	bijwoord
beroepshalve	bijwoord
beurtelings	bijwoord
bijgeval	bijwoord
bijgevolg	bijwoord
billijkheidshalve	bijwoord
circa	bijwoord
daarenboven	bijwoord
danig	bijwoord
danwel	bijwoord
derhalve	bijwoord
dermate	bijwoord
desalniettemin	bijwoord
desgevraagd	bijwoord
desniettegenstaande	bijwoord
desondanks	bijwoord
destijds	bijwoord
deswege	bijwoord
dezerzijds	bijwoord
dienaangaande	bijwoord
dienovereenkomstig	bijwoord
dientengevolge	bijwoord
doch	bijwoord
doorgaans	bijwoord
duidelijkheidshalve	bijwoord
dusdanig	bijwoord
echter	bijwoord
edoch	bijwoord
eenvoudigheidshalve	bijwoord
eerdaags	bijwoord
eerlijkheidshalve	bijwoord
eerst dan	bijwoord
eerstdan	bijwoord
elders	bijwoord
enerzijds	bijwoord
enigszins	bijwoord
enkel	bijwoord
ergo	bijwoord
eveneens	bijwoord
evenmin	bijwoord
evenwel	bijwoord
evenzeer	bijwoord
evenzo	bijwoord
fasegewijs	bijwoord
fatsoenshalve	bijwoord
gaarne	bijwoord
geenszins	bijwoord
gemakshalve	bijwoord
gemeenlijk	bijwoord
genoegzaam	bijwoord
gewetenshalve	bijwoord
gezondheidshalve	bijwoord
grosso modo	bijwoord
heden	bijwoord
hedenmiddag	bijwoord
hedenmorgen	bijwoord
hedenochtend	bijwoord
hier te lande	bijwoord
hieromtrent	bijwoord
hiertoe	bijwoord
hoofdzakelijk	bijwoord
ietwat	bijwoord
immers	bijwoord
incluis	bijwoord
indertijd	bijwoord
jongstleden	bijwoord
kortelings	bijwoord
kortheidshalve	bijwoord
laatstelijk	bijwoord
louter	bijwoord
mede	bijwoord
medio	bijwoord
meestentijds	bijwoord
menigmaal	bijwoord
merendeels	bijwoord
mijns inziens	bijwoord
mitsdien	bijwoord
mitsgaders	bijwoord
momenteel	bijwoord
nadien	bijwoord
nagenoeg	bijwoord
niettemin	bijwoord
nimmer	bijwoord
nochtans	bijwoord
onderwijl	bijwoord
onlangs	bijwoord
onverwijld	bijwoord
onzerzijds	bijwoord
onzes inziens	bijwoord
overigens	bijwoord
overwegend	bijwoord
plichtshalve	bijwoord
quasi	bijwoord
recentelijk	bijwoord
rechtens	bijwoord
reeds	bijwoord
slechts	bijwoord
somtijds	bijwoord
te onzent	bijwoord
telkenmale	bijwoord
ten minste	bijwoord
ten principale	bijwoord
ten volle	bijwoord
terdege	bijwoord
terstond	bijwoord
terzijde	bijwoord
tevens	bijwoord
tevoren	bijwoord
tezamen	bijwoord
thans	bijwoord
toentertijd	bijwoord
uiteraard	bijwoord
ultimo	bijwoord
uwenthalve	bijwoord
uwentwege	bijwoord
uwerzijds	bijwoord
veelal	bijwoord
veiligheidshalve	bijwoord
volgaarne	bijwoord
volledigheidshalve	bijwoord
voorafgaandelijk	bijwoord
vooralsnog	bijwoord
voorheen	bijwoord
voorshands	bijwoord
voorts	bijwoord
voorzichtigheidshalve	bijwoord
vrijwel	bijwoord
wederom	bijwoord
weliswaar	bijwoord
wellicht	bijwoord
willens en wetens	bijwoord
zekerheidshalve	bijwoord
zijdelings	bijwoord
zodoende	bijwoord
al dan niet	bijwoordgroep
aangezien	voegwoord
alhoewel	voegwoord
als ware	voegwoord
alsmede	voegwoord
alsook	voegwoord
alvorens	voegwoord
dan wel	voegwoord
hoewel	voegwoord
indien	voegwoord
ingeval	voegwoord
inzake	voegwoord
mits	voegwoord
naargelang	voegwoord
ofschoon	voegwoord
oftewel	voegwoord
opdat	voegwoord
sedert	voegwoord
teneinde	voegwoord
tenzij	voegwoord
vooraleer	voegwoord
alwaar	voornaamwoord
degeen	voornaamwoord
dergelijke	voornaamwoord
eenzelfde	voornaamwoord
eerdergenoemde	voornaamwoord
enige	voornaamwoord
enigerlei	voornaamwoord
ettelijke	voornaamwoord
hetgeen	voornaamwoord
hetwelk	voornaamwoord
hiernavolgende	voornaamwoord
hogergenoemde	voornaamwoord
menigeen	voornaamwoord
nevenstaande	voornaamwoord
quod non	voornaamwoord
u	voornaamwoord
uw	voornaamwoord
verscheidene	voornaamwoord
voorliggend	voornaamwoord
voormeld	voornaamwoord
vorenbedoelde	voornaamwoord
waaromtrent	voornaamwoord
weshalve	voornaamwoord
wiens	voornaamwoord
zodanig	voornaamwoord
zulks	voornaamwoord
een en ander	voornaamwoordgroep
aangaande	voorzetsel
behoudens	voorzetsel
benevens	voorzetsel
betreffende	voorzetsel
blijkens	voorzetsel
conform	voorzetsel
gedurende	voorzetsel
gezien	voorzetsel
hangende	voorzetsel
ingevolge	voorzetsel
jegens	voorzetsel
krachtens	voorzetsel
middels	voorzetsel
niettegenstaande	voorzetsel
nopens	voorzetsel
omtrent	voorzetsel
ongeacht	voorzetsel
overeenkomstig	voorzetsel
qua	voorzetsel
ter zake	voorzetsel
wat betreft	voorzetsel
zijdens	voorzetsel
a posteriori	voorzetselgroep
a priori 	voorzetselgroep
aan de hand van	voorzetselgroep
aan het adres van	voorzetselgroep
ad hoc	voorzetselgroep
afgezien van 	voorzetselgroep
als gevolg van	voorzetselgroep
als zodanig	voorzetselgroep
bij brief	voorzetselgroep
bij de gratie van	voorzetselgroep
bij dezen	voorzetselgroep
bij gebrek aan	voorzetselgroep
bij gelegenheid	voorzetselgroep
bij monde van	voorzetselgroep
bij wijze van	voorzetselgroep
buiten medeweten van	voorzetselgroep
casu quo	voorzetselgroep
cum suis	voorzetselgroep
de dato	voorzetselgroep
de facto	voorzetselgroep
der	voorzetselgroep
dezer dagen	voorzetselgroep
door gebrek aan	voorzetselgroep
door middel van	voorzetselgroep
door toedoen van	voorzetselgroep
gedurende de tijd dat	voorzetselgroep
gezien het feit dat	voorzetselgroep
heden ten dage	voorzetselgroep
in beginsel	voorzetselgroep
in casu	voorzetselgroep
in concreto	voorzetselgroep
in de eerste instantie	voorzetselgroep
in de loop van	voorzetselgroep
in de nabije toekomst	voorzetselgroep
in de nabijheid van	voorzetselgroep
in de richting van	voorzetselgroep
in de sfeer van	voorzetselgroep
in de trant van	voorzetselgroep
in de zin van	voorzetselgroep
in dezen	voorzetselgroep
in dier voege	voorzetselgroep
in duplo	voorzetselgroep
in een poging om	voorzetselgroep
in eigendom van	voorzetselgroep
in geval van	voorzetselgroep
in goede orde	voorzetselgroep
in het geval dat	voorzetselgroep
in het kader van	voorzetselgroep
in het licht van	voorzetselgroep
in het merendeel van de gevallen	voorzetselgroep
in mindere mate	voorzetselgroep
in naam van	voorzetselgroep
in opdracht van	voorzetselgroep
in oude luister	voorzetselgroep
in overeenstemming met	voorzetselgroep
in overleg met	voorzetselgroep
in reactie op	voorzetselgroep
in samenwerking met	voorzetselgroep
in situ	voorzetselgroep
in strijd met	voorzetselgroep
in tegenstelling met	voorzetselgroep
in tegenstelling tot	voorzetselgroep
in termen van	voorzetselgroep
in verband met	voorzetselgroep
in verhouding tot	voorzetselgroep
in weerwil van	voorzetselgroep
in zoverre als	voorzetselgroep
ingeval van	voorzetselgroep
met als gevolg dat	voorzetselgroep
met als reden	voorzetselgroep
met als resultaat dat	voorzetselgroep
met behoud van	voorzetselgroep
met behulp van	voorzetselgroep
met betrekking tot	voorzetselgroep
met dank aan	voorzetselgroep
met de bedoeling dat	voorzetselgroep
met gebruikmaking van	voorzetselgroep
met het doel om	voorzetselgroep
met het oog op	voorzetselgroep
met het resultaat dat	voorzetselgroep
met inachtneming van	voorzetselgroep
met ingang van	voorzetselgroep
met medewerking van	voorzetselgroep
met medeweten van	voorzetselgroep
met name	voorzetselgroep
met redenen omkleed	voorzetselgroep
met referte aan	voorzetselgroep
met terzijde laten van	voorzetselgroep
met uitzondering van	voorzetselgroep
met weglating van	voorzetselgroep
na afloop van	voorzetselgroep
na verloop van	voorzetselgroep
naar aanleiding van	voorzetselgroep
naar behoren	voorzetselgroep
om deze reden	voorzetselgroep
om deze redenen	voorzetselgroep
om niet	voorzetselgroep
om reden van	voorzetselgroep
om te komen tot	voorzetselgroep
omwille	voorzetselgroep
ondanks het feit dat	voorzetselgroep
onder invloed van	voorzetselgroep
onder leiding van	voorzetselgroep
onder meer	voorzetselgroep
onder referte aan	voorzetselgroep
onder verwijzing naar	voorzetselgroep
ons inziens	voorzetselgroep
op advies van	voorzetselgroep
op basis van	voorzetselgroep
op de volgende wijze	voorzetselgroep
op deze wijze	voorzetselgroep
op grond van	voorzetselgroep
op het gebied van	voorzetselgroep
op het huidige moment	voorzetselgroep
op het stuk van	voorzetselgroep
op hoofdlijnen	voorzetselgroep
op initiatief van	voorzetselgroep
op prettige wijze	voorzetselgroep
op uitnodiging van	voorzetselgroep
op vertoon van	voorzetselgroep
op verzoek van	voorzetselgroep
op voorhand	voorzetselgroep
op voorspraak van	voorzetselgroep
op welke wijze	voorzetselgroep
per omgaande	voorzetselgroep
prima facie	voorzetselgroep
te allen tijde	voorzetselgroep
te bestemder tijd	voorzetselgroep
te dezen	voorzetselgroep
te elfder ure	voorzetselgroep
te midden van	voorzetselgroep
te uwen name	voorzetselgroep
te uwent	voorzetselgroep
te zijner tijd	voorzetselgroep
tegen betaling van	voorzetselgroep
tegen de achtergrond van	voorzetselgroep
ten aanzien van	voorzetselgroep
ten bate van	voorzetselgroep
ten bedrage van	voorzetselgroep
ten behoeve van	voorzetselgroep
ten bewijze van	voorzetselgroep
ten dele	voorzetselgroep
ten detrimente van	voorzetselgroep
ten enenmale	voorzetselgroep
ten gerieve van	voorzetselgroep
ten gevolge van	voorzetselgroep
ten gunste van	voorzetselgroep
ten kantore	voorzetselgroep
ten koste van	voorzetselgroep
ten nadele van	voorzetselgroep
ten opzichte van	voorzetselgroep
ten overstaan van	voorzetselgroep
ten tijde van	voorzetselgroep
ten uitvoer	voorzetselgroep
ten vervolge op	voorzetselgroep
ten voordele van	voorzetselgroep
ter attentie van	voorzetselgroep
ter bereiking hiervan	voorzetselgroep
ter beschikking	voorzetselgroep
ter bestemde plaatse	voorzetselgroep
ter gelegenheid van	voorzetselgroep
ter hand	voorzetselgroep
ter hoogte van	voorzetselgroep
ter plaatse	voorzetselgroep
ter wille van	voorzetselgroep
ter zake	voorzetselgroep
ter zake van	voorzetselgroep
ter zitting	voorzetselgroep
uit een oogpunt van	voorzetselgroep
uit het oogpunt van	voorzetselgroep
uit hoofde van	voorzetselgroep
uit kracht van	voorzetselgroep
uit naam van	voorzetselgroep
van de kant van	voorzetselgroep
van de zijde van	voorzetselgroep
van gemeentewege	voorzetselgroep
van mening	voorzetselgroep
van oordeel	voorzetselgroep
voor het geval dat	voorzetselgroep
voor rekening van	voorzetselgroep
voor wat betreft	voorzetselgroep
zonder uitzondering	voorzetselgroep
aanbevelen	werkwoord
aanmerken	werkwoord
aanreiken	werkwoord
aanschaffen	werkwoord
aantreffen	werkwoord
aanvangen	werkwoord
aanvechten	werkwoord
aanwenden	werkwoord
aanwrijven	werkwoord
accommoderen	werkwoord
accorderen	werkwoord
achten	werkwoord
actualiseren	werkwoord
adoreren	werkwoord
adstrueren	werkwoord
afbakenen	werkwoord
agenderen	werkwoord
alloceren	werkwoord
anticiperen	werkwoord
appelleren	werkwoord
appreciëren	werkwoord
articuleren	werkwoord
attenderen	werkwoord
bagatelliseren	werkwoord
beamen	werkwoord
begeren	werkwoord
behagen	werkwoord
behartigen	werkwoord
behelzen	werkwoord
behoeden	werkwoord
behoeven	werkwoord
behoren	werkwoord
bejegenen	werkwoord
beklijven	werkwoord
belagen	werkwoord
bemachtigen	werkwoord
bemoeilijken	werkwoord
benodigen	werkwoord
beogen	werkwoord
beproeven	werkwoord
beraden	werkwoord
berichten	werkwoord
berispen	werkwoord
beschamen	werkwoord
bestempelen	werkwoord
bestendigen	werkwoord
bestrijken	werkwoord
betitelen	werkwoord
betreft	werkwoord
betrekken	werkwoord
betreuren	werkwoord
betuigen	werkwoord
bevatten	werkwoord
bewerkstelligen	werkwoord
bezegelen	werkwoord
bezien	werkwoord
bezigen	werkwoord
bijdragen	werkwoord
bijvoegen	werkwoord
borgen	werkwoord
chargeren	werkwoord
classificeren	werkwoord
clusteren	werkwoord
collaboreren	werkwoord
committeren	werkwoord
compenseren	werkwoord
completeren	werkwoord
compliceren	werkwoord
compromitteren	werkwoord
concipiëren	werkwoord
concretiseren	werkwoord
conflicteren	werkwoord
constateren	werkwoord
constitueren	werkwoord
consulteren	werkwoord
continueren	werkwoord
copuleren	werkwoord
creëren	werkwoord
culmineren	werkwoord
dankzeggen	werkwoord
derven	werkwoord
derving	werkwoord
desintegreren	werkwoord
determineren	werkwoord
dienen	werkwoord
differentiëren	werkwoord
distribueren	werkwoord
divageren	werkwoord
doneren	werkwoord
doubleren	werkwoord
dralen	werkwoord
dupliceren	werkwoord
effectueren	werkwoord
elimineren	werkwoord
entameren	werkwoord
escaleren	werkwoord
excelleren	werkwoord
excerperen	werkwoord
expliceren	werkwoord
expliciteren	werkwoord
exploreren	werkwoord
fabriceren	werkwoord
faciliteren	werkwoord
falsificeren	werkwoord
fascineren	werkwoord
faseren	werkwoord
fiatteren	werkwoord
flaneren	werkwoord
fluctueren	werkwoord
fnuiken	werkwoord
functioneren	werkwoord
funderen	werkwoord
fungeren	werkwoord
gedenken	werkwoord
gelieve	werkwoord
gelukken	werkwoord
genereren	werkwoord
geraken	werkwoord
geschieden	werkwoord
gispen	werkwoord
grieven	werkwoord
handelen	werkwoord
herbergen	werkwoord
heroriënteren	werkwoord
heroverwegen	werkwoord
honoreren	werkwoord
hoogachten	werkwoord
implementeren	werkwoord
impliceren	werkwoord
imponeren	werkwoord
inachtnemen	werkwoord
inbedden	werkwoord
indiceren	werkwoord
indoctrineren	werkwoord
initiëren	werkwoord
innoveren	werkwoord
insisteren	werkwoord
institutionaliseren	werkwoord
integreren	werkwoord
intensiveren	werkwoord
interageren	werkwoord
interrumperen	werkwoord
interveniëren	werkwoord
inventariseren	werkwoord
involveren	werkwoord
inwilligen	werkwoord
kennisnemen	werkwoord
krenken	werkwoord
kwalificeren	werkwoord
kwantificeren	werkwoord
laken	werkwoord
larderen	werkwoord
legitimeren	werkwoord
loven	werkwoord
manen	werkwoord
manifesteren	werkwoord
mededelen	werkwoord
memoreren	werkwoord
minachten	werkwoord
mitigeren	werkwoord
monitoren	werkwoord
motiveren	werkwoord
musiceren	werkwoord
nadragen	werkwoord
nastreven	werkwoord
nevenvermelde	werkwoord
noodzaken	werkwoord
nopen	werkwoord
noteren	werkwoord
nuttigen	werkwoord
onderkennen	werkwoord
onderschrijven	werkwoord
_ontaarden	werkwoord
ontberen	werkwoord
ontbieden	werkwoord
ontdoen	werkwoord
ontgaan	werkwoord
ontgelden	werkwoord
ontgoochelen	werkwoord
ontgroeien	werkwoord
ontketenen	werkwoord
ontkomen	werkwoord
ontkrachten	werkwoord
ontkronen	werkwoord
ontluiken	werkwoord
ontmantelen	werkwoord
ontnemen	werkwoord
ontplooien	werkwoord
ontraden	werkwoord
ontroeren	werkwoord
ontrollen	werkwoord
ontschepen	werkwoord
ontschieten	werkwoord
ontsieren	werkwoord
ontsluieren	werkwoord
ontsluiten	werkwoord
onttakelen	werkwoord
onttrekken	werkwoord
ontvallen	werkwoord
ontvangen	werkwoord
ontvouwen	werkwoord
ontwaren	werkwoord
ontzenuwen	werkwoord
opteren	werkwoord
optimaliseren	werkwoord
overeenkomen	werkwoord
overhandigen	werkwoord
overwegen	werkwoord
paraferen	werkwoord
participeren	werkwoord
percipiëren	werkwoord
persisteren	werkwoord
plaatsen	werkwoord
plengen	werkwoord
plezieren	werkwoord
pogen	werkwoord
prefereren	werkwoord
preluderen	werkwoord
pretenderen	werkwoord
prevaleren	werkwoord
prioriteren	werkwoord
produceren	werkwoord
profileren	werkwoord
prognosticeren	werkwoord
prognotiseren	werkwoord
prolongeren	werkwoord
provoceren	werkwoord
ramen	werkwoord
rapporteren	werkwoord
realiseren	werkwoord
recapituleren	werkwoord
recreëren	werkwoord
rectificeren	werkwoord
reduceren	werkwoord
refereren	werkwoord
reflecteren	werkwoord
regarderen	werkwoord
repliceren	werkwoord
resideren	werkwoord
respecteren	werkwoord
ressorteren	werkwoord
resteren	werkwoord
restitueren	werkwoord
resulteren	werkwoord
resumeren	werkwoord
retourneren	werkwoord
ridiculiseren	werkwoord
rondwaren	werkwoord
rubriceren	werkwoord
sanctioneren	werkwoord
schikken	werkwoord
schromen	werkwoord
specificeren	werkwoord
speculeren	werkwoord
structureren	werkwoord
symboliseren	werkwoord
tegemoetkomen	werkwoord
tegemoetzien	werkwoord
temporiseren	werkwoord
terechtwijzen	werkwoord
tergen	werkwoord
terugmelden	werkwoord
tiranniseren	werkwoord
toetsen	werkwoord
toeven	werkwoord
tolereren	werkwoord
totstandbrengen	werkwoord
totstandkomen	werkwoord
trachten	werkwoord
transformeren	werkwoord
triomferen	werkwoord
uiteenzetten	werkwoord
uitkristalliseren	werkwoord
uitrichten	werkwoord
uitweiden	werkwoord
uitzonderen	werkwoord
uniformiseren	werkwoord
verachten	werkwoord
verdoezelen	werkwoord
vereffenen	werkwoord
vereisen	werkwoord
vergen	werkwoord
vergewissen	werkwoord
vergezellen	werkwoord
verguizen	werkwoord
verifiëren	werkwoord
verkrijgen	werkwoord
verloochenen	werkwoord
vermanen	werkwoord
vernemen	werkwoord
verrichten	werkwoord
verstrijken	werkwoord
vertoeven	werkwoord
vervaardigen	werkwoord
verwaardigen	werkwoord
verwerven	werkwoord
verweven	werkwoord
verzoeken	werkwoord
verzuimen	werkwoord
vigeren	werkwoord
volbrengen	werkwoord
voldoen	werkwoord
voltooien	werkwoord
vomeren	werkwoord
voornemens	werkwoord
voortzetten	werkwoord
vorsen	werkwoord
vrezen	werkwoord
vrijwaren	werkwoord
waarborgen	werkwoord
waarnemen	werkwoord
weerleggen	werkwoord
weerspreken	werkwoord
wensen	werkwoord
wijzigen	werkwoord
zegevieren	werkwoord
zorgdragen	werkwoord
zwichten	werkwoord
aanbevelenswaardigheid	zelfstandig naamwoord
aandoening	zelfstandig naamwoord
aanlokkelijkheid	zelfstandig naamwoord
aanmerking	zelfstandig naamwoord
aannemelijkheid	zelfstandig naamwoord
aantijging	zelfstandig naamwoord
aanvang	zelfstandig naamwoord
aanvechtbaarheid	zelfstandig naamwoord
abattoir	zelfstandig naamwoord
abdicatie	zelfstandig naamwoord
absentie	zelfstandig naamwoord
absurditeit	zelfstandig naamwoord
abundantie	zelfstandig naamwoord
acceptatie	zelfstandig naamwoord
accommodatie	zelfstandig naamwoord
accuratesse	zelfstandig naamwoord
achilleshiel	zelfstandig naamwoord
achttal	zelfstandig naamwoord
adagium	zelfstandig naamwoord
aderlating	zelfstandig naamwoord
adhesie	zelfstandig naamwoord
adoratie	zelfstandig naamwoord
afbakening	zelfstandig naamwoord
afdoening	zelfstandig naamwoord
affiniteit	zelfstandig naamwoord
afgezant	zelfstandig naamwoord
afgunst	zelfstandig naamwoord
alliantie	zelfstandig naamwoord
alternatief	zelfstandig naamwoord
ambiguïteit	zelfstandig naamwoord
animo	zelfstandig naamwoord
animositeit	zelfstandig naamwoord
annonce	zelfstandig naamwoord
anonimiteit	zelfstandig naamwoord
anticipatie	zelfstandig naamwoord
antipathie	zelfstandig naamwoord
apotheose	zelfstandig naamwoord
appreciatie	zelfstandig naamwoord
archipel	zelfstandig naamwoord
articulatie	zelfstandig naamwoord
aspect	zelfstandig naamwoord
assertiviteit	zelfstandig naamwoord
assistentie	zelfstandig naamwoord
associatie	zelfstandig naamwoord
attentie	zelfstandig naamwoord
attitude	zelfstandig naamwoord
auditorium	zelfstandig naamwoord
aureool	zelfstandig naamwoord
auspiciën	zelfstandig naamwoord
authenticiteit	zelfstandig naamwoord
autonomie	zelfstandig naamwoord
banaliteit	zelfstandig naamwoord
bedroefdheid	zelfstandig naamwoord
beduchtheid	zelfstandig naamwoord
begeerte	zelfstandig naamwoord
behartiging	zelfstandig naamwoord
bejegening	zelfstandig naamwoord
belanghebbende	zelfstandig naamwoord
benodigdheden	zelfstandig naamwoord
beproeving	zelfstandig naamwoord
berisping	zelfstandig naamwoord
berouw	zelfstandig naamwoord
bescheiden	zelfstandig naamwoord
beschermwaardigheid	zelfstandig naamwoord
beschroomdheid	zelfstandig naamwoord
beslommering	zelfstandig naamwoord
betrekking	zelfstandig naamwoord
betreurenswaardigheid	zelfstandig naamwoord
bewonderenswaardigheid	zelfstandig naamwoord
bezienswaardigheid	zelfstandig naamwoord
calamiteit	zelfstandig naamwoord
capaciteit	zelfstandig naamwoord
catastrofe	zelfstandig naamwoord
categorie	zelfstandig naamwoord
causaliteit	zelfstandig naamwoord
celebrant	zelfstandig naamwoord
charisma	zelfstandig naamwoord
cineast	zelfstandig naamwoord
clementie	zelfstandig naamwoord
cohesie	zelfstandig naamwoord
coïncidentie	zelfstandig naamwoord
collaboratie	zelfstandig naamwoord
collectie	zelfstandig naamwoord
commotie	zelfstandig naamwoord
compassie	zelfstandig naamwoord
compensatie	zelfstandig naamwoord
competentie	zelfstandig naamwoord
complexiteit	zelfstandig naamwoord
concept	zelfstandig naamwoord
confidentie	zelfstandig naamwoord
configuratie	zelfstandig naamwoord
connotatie	zelfstandig naamwoord
consensus	zelfstandig naamwoord
consequentie	zelfstandig naamwoord
consideratie	zelfstandig naamwoord
consistentie	zelfstandig naamwoord
consolidatie	zelfstandig naamwoord
constatering	zelfstandig naamwoord
constellatie	zelfstandig naamwoord
consternatie	zelfstandig naamwoord
continuïteit	zelfstandig naamwoord
continuüm	zelfstandig naamwoord
contour	zelfstandig naamwoord
controverse	zelfstandig naamwoord
conventie	zelfstandig naamwoord
convocatie	zelfstandig naamwoord
copulatie	zelfstandig naamwoord
corpulentie	zelfstandig naamwoord
correspondentie	zelfstandig naamwoord
creatie	zelfstandig naamwoord
criminaliteit	zelfstandig naamwoord
criterium	zelfstandig naamwoord
culminatie	zelfstandig naamwoord
cumulatie	zelfstandig naamwoord
curiosa	zelfstandig naamwoord
curiositeit	zelfstandig naamwoord
decennium	zelfstandig naamwoord
deceptie	zelfstandig naamwoord
deconfiture	zelfstandig naamwoord
deerniswaardigheid	zelfstandig naamwoord
delegatie	zelfstandig naamwoord
dertiental	zelfstandig naamwoord
dertigtal	zelfstandig naamwoord
desiderata	zelfstandig naamwoord
desideratum	zelfstandig naamwoord
desintegratie	zelfstandig naamwoord
desinteresse	zelfstandig naamwoord
despoot	zelfstandig naamwoord
despotie	zelfstandig naamwoord
despotisme	zelfstandig naamwoord
detentie	zelfstandig naamwoord
determinant	zelfstandig naamwoord
devotie	zelfstandig naamwoord
dimensie	zelfstandig naamwoord
discontinuïteit	zelfstandig naamwoord
discrepantie	zelfstandig naamwoord
dissociatie	zelfstandig naamwoord
distantie	zelfstandig naamwoord
domicilie	zelfstandig naamwoord
donatie	zelfstandig naamwoord
doorgang	zelfstandig naamwoord
doublure	zelfstandig naamwoord
douceur	zelfstandig naamwoord
draagvlak	zelfstandig naamwoord
drietal	zelfstandig naamwoord
droefenis	zelfstandig naamwoord
drogreden	zelfstandig naamwoord
dynamiek	zelfstandig naamwoord
echtgenoot	zelfstandig naamwoord
educatie	zelfstandig naamwoord
eerbetoon	zelfstandig naamwoord
eerbiedwaardigheid	zelfstandig naamwoord
egards	zelfstandig naamwoord
einzelgänger	zelfstandig naamwoord
elan	zelfstandig naamwoord
electoraat	zelfstandig naamwoord
eliminatie	zelfstandig naamwoord
eliminering	zelfstandig naamwoord
eloquentie	zelfstandig naamwoord
empathie	zelfstandig naamwoord
enigma	zelfstandig naamwoord
enormiteit	zelfstandig naamwoord
epiloog	zelfstandig naamwoord
epistel	zelfstandig naamwoord
equivalentie	zelfstandig naamwoord
erkentelijkheid	zelfstandig naamwoord
erotiek	zelfstandig naamwoord
eruditie	zelfstandig naamwoord
escalatie	zelfstandig naamwoord
essentie	zelfstandig naamwoord
euforie	zelfstandig naamwoord
evocatie	zelfstandig naamwoord
excentriciteit	zelfstandig naamwoord
exces	zelfstandig naamwoord
explicatie	zelfstandig naamwoord
exploratie	zelfstandig naamwoord
exposé	zelfstandig naamwoord
extensivering	zelfstandig naamwoord
exterieur	zelfstandig naamwoord
façade	zelfstandig naamwoord
faciliteit	zelfstandig naamwoord
fascinatie	zelfstandig naamwoord
feil	zelfstandig naamwoord
festiviteit	zelfstandig naamwoord
fiat	zelfstandig naamwoord
fictie	zelfstandig naamwoord
fiducie	zelfstandig naamwoord
filantroop	zelfstandig naamwoord
fixatie	zelfstandig naamwoord
flatulentie	zelfstandig naamwoord
flauwiteit	zelfstandig naamwoord
flegma	zelfstandig naamwoord
fluctuatie	zelfstandig naamwoord
fragiliteit	zelfstandig naamwoord
frictie	zelfstandig naamwoord
frivoliteit	zelfstandig naamwoord
fundament	zelfstandig naamwoord
futiliteit	zelfstandig naamwoord
gedenkwaardigheid	zelfstandig naamwoord
geestdrift	zelfstandig naamwoord
gelegenheid	zelfstandig naamwoord
gelijkwaardigheid	zelfstandig naamwoord
gemoed	zelfstandig naamwoord
gemoedstoestand	zelfstandig naamwoord
geneesheer	zelfstandig naamwoord
genoegen	zelfstandig naamwoord
geraffineerdheid	zelfstandig naamwoord
geringschatting	zelfstandig naamwoord
geschil	zelfstandig naamwoord
gewag	zelfstandig naamwoord
gratie	zelfstandig naamwoord
gronden	zelfstandig naamwoord
grondslag	zelfstandig naamwoord
handreiking	zelfstandig naamwoord
hartstocht	zelfstandig naamwoord
hebbelijkheid	zelfstandig naamwoord
hegemonie	zelfstandig naamwoord
heroïek	zelfstandig naamwoord
heroriëntatie	zelfstandig naamwoord
het feit dat	zelfstandig naamwoord
hiërarchie	zelfstandig naamwoord
hilariteit	zelfstandig naamwoord
honorarium	zelfstandig naamwoord
hoofde	zelfstandig naamwoord
hoofdlijnen	zelfstandig naamwoord
huzarenstukje	zelfstandig naamwoord
ignorantie	zelfstandig naamwoord
illegaliteit	zelfstandig naamwoord
illuminatie	zelfstandig naamwoord
impertinentie	zelfstandig naamwoord
implementatie	zelfstandig naamwoord
implicatie	zelfstandig naamwoord
importantie	zelfstandig naamwoord
inactiviteit	zelfstandig naamwoord
inbedding	zelfstandig naamwoord
incident	zelfstandig naamwoord
indicatie	zelfstandig naamwoord
indifferentie	zelfstandig naamwoord
indoctrinatie	zelfstandig naamwoord
initiatie	zelfstandig naamwoord
initiatiefnemer	zelfstandig naamwoord
innovatie	zelfstandig naamwoord
instrumentarium	zelfstandig naamwoord
integriteit	zelfstandig naamwoord
intensiteit	zelfstandig naamwoord
intentie	zelfstandig naamwoord
interactie	zelfstandig naamwoord
interbellum	zelfstandig naamwoord
interieur	zelfstandig naamwoord
intermediair	zelfstandig naamwoord
interpretatie	zelfstandig naamwoord
interruptie	zelfstandig naamwoord
interventie	zelfstandig naamwoord
intolerantie	zelfstandig naamwoord
intonatie	zelfstandig naamwoord
inventarisatie	zelfstandig naamwoord
invitatie	zelfstandig naamwoord
inwilliging	zelfstandig naamwoord
ironie	zelfstandig naamwoord
irrelevantie	zelfstandig naamwoord
item	zelfstandig naamwoord
jobstijding	zelfstandig naamwoord
kakafonie	zelfstandig naamwoord
keramiek	zelfstandig naamwoord
kleptomaan	zelfstandig naamwoord
kosmopoliet	zelfstandig naamwoord
kroniek	zelfstandig naamwoord
kwalificatie	zelfstandig naamwoord
kwantiteit	zelfstandig naamwoord
labiliteit	zelfstandig naamwoord
lankmoedigheid	zelfstandig naamwoord
ledematen	zelfstandig naamwoord
leedwezen	zelfstandig naamwoord
leidraad	zelfstandig naamwoord
levitatie	zelfstandig naamwoord
lezenswaardigheid	zelfstandig naamwoord
liaison	zelfstandig naamwoord
lichaamsbeweging	zelfstandig naamwoord
locatie	zelfstandig naamwoord
lovenswaardigheid	zelfstandig naamwoord
maal	zelfstandig naamwoord
mandaat	zelfstandig naamwoord
massaliteit	zelfstandig naamwoord
mededeling	zelfstandig naamwoord
mededogen	zelfstandig naamwoord
melancholie	zelfstandig naamwoord
metaforiek	zelfstandig naamwoord
methode	zelfstandig naamwoord
methodiek	zelfstandig naamwoord
metropool	zelfstandig naamwoord
millenium	zelfstandig naamwoord
mimiek	zelfstandig naamwoord
minachting	zelfstandig naamwoord
misnoegen	zelfstandig naamwoord
mobiliteit	zelfstandig naamwoord
momentum	zelfstandig naamwoord
motoriek	zelfstandig naamwoord
motorrijwiel	zelfstandig naamwoord
naïviteit	zelfstandig naamwoord
nastrevenswaardigheid	zelfstandig naamwoord
navolgenswaardigheid	zelfstandig naamwoord
negental	zelfstandig naamwoord
nevenactiviteit	zelfstandig naamwoord
nevenbedoeling	zelfstandig naamwoord
nevenbelang	zelfstandig naamwoord
nevendoel	zelfstandig naamwoord
neveneffect	zelfstandig naamwoord
nevenfunctie	zelfstandig naamwoord
nevengevolg	zelfstandig naamwoord
neventaak	zelfstandig naamwoord
nevenverschijnsel	zelfstandig naamwoord
noodzakelijkheid	zelfstandig naamwoord
notificatie	zelfstandig naamwoord
obsceniteit	zelfstandig naamwoord
omstandigheid	zelfstandig naamwoord
onaannemelijkheid	zelfstandig naamwoord
onaantastbaarheid	zelfstandig naamwoord
ondergetekende	zelfstandig naamwoord
onderricht	zelfstandig naamwoord
onderuitputting	zelfstandig naamwoord
oneffenheid	zelfstandig naamwoord
onenigheid	zelfstandig naamwoord
ongelijkwaardigheid	zelfstandig naamwoord
ongeloofwaardigheid	zelfstandig naamwoord
ongenoegen	zelfstandig naamwoord
ongerechtigheid	zelfstandig naamwoord
ongeregeldheden	zelfstandig naamwoord
ongeval	zelfstandig naamwoord
onhebbelijkheid	zelfstandig naamwoord
onjuistheid	zelfstandig naamwoord
ontaarding	zelfstandig naamwoord
ontbering	zelfstandig naamwoord
ontboezeming	zelfstandig naamwoord
ontgoocheling	zelfstandig naamwoord
ontkrachting	zelfstandig naamwoord
ontkroning	zelfstandig naamwoord
ontmanteling	zelfstandig naamwoord
ontneming	zelfstandig naamwoord
ontplooiing	zelfstandig naamwoord
ontreddering	zelfstandig naamwoord
ontroering	zelfstandig naamwoord
ontscheping	zelfstandig naamwoord
ontsluiering	zelfstandig naamwoord
ontsluiting	zelfstandig naamwoord
ontsteltenis	zelfstandig naamwoord
onttakeling	zelfstandig naamwoord
onttrekking	zelfstandig naamwoord
ontvankelijkheid	zelfstandig naamwoord
ontzetting	zelfstandig naamwoord
oogmerk	zelfstandig naamwoord
openbaarheid	zelfstandig naamwoord
opposant	zelfstandig naamwoord
outillage	zelfstandig naamwoord
ovatie	zelfstandig naamwoord
overweging	zelfstandig naamwoord
pariteit	zelfstandig naamwoord
participatie	zelfstandig naamwoord
pedagogiek	zelfstandig naamwoord
pedanterie	zelfstandig naamwoord
percent	zelfstandig naamwoord
perceptie	zelfstandig naamwoord
periferie	zelfstandig naamwoord
periode	zelfstandig naamwoord
persoon	zelfstandig naamwoord
pertinentie	zelfstandig naamwoord
perversiteit	zelfstandig naamwoord
piëteit	zelfstandig naamwoord
platitude	zelfstandig naamwoord
plausibiliteit	zelfstandig naamwoord
polemiek	zelfstandig naamwoord
potentie	zelfstandig naamwoord
preferentie	zelfstandig naamwoord
presentie	zelfstandig naamwoord
prijzenswaardigheid	zelfstandig naamwoord
principe	zelfstandig naamwoord
prioriteit	zelfstandig naamwoord
prioriteitsstelling	zelfstandig naamwoord
problematiek	zelfstandig naamwoord
procedure	zelfstandig naamwoord
prognose	zelfstandig naamwoord
projectiel	zelfstandig naamwoord
proleet	zelfstandig naamwoord
prolongatie	zelfstandig naamwoord
protegé	zelfstandig naamwoord
provocatie	zelfstandig naamwoord
prudentie	zelfstandig naamwoord
puëriliteit	zelfstandig naamwoord
pugilistiek	zelfstandig naamwoord
pyromaan	zelfstandig naamwoord
raffinement	zelfstandig naamwoord
raming	zelfstandig naamwoord
randvoorwaarden	zelfstandig naamwoord
rapaille	zelfstandig naamwoord
rapportage	zelfstandig naamwoord
rariteit	zelfstandig naamwoord
rationaliteit	zelfstandig naamwoord
realisatie	zelfstandig naamwoord
recapitulatie	zelfstandig naamwoord
rechtschapenheid	zelfstandig naamwoord
recreant	zelfstandig naamwoord
rectificatie	zelfstandig naamwoord
reductie	zelfstandig naamwoord
redundantie	zelfstandig naamwoord
referendum	zelfstandig naamwoord
referentie	zelfstandig naamwoord
referte	zelfstandig naamwoord
relevantie	zelfstandig naamwoord
relocatie	zelfstandig naamwoord
repercussie	zelfstandig naamwoord
repliek	zelfstandig naamwoord
reservoir	zelfstandig naamwoord
residentie	zelfstandig naamwoord
respons	zelfstandig naamwoord
ressentiment	zelfstandig naamwoord
restitutie	zelfstandig naamwoord
restrictie	zelfstandig naamwoord
resumé	zelfstandig naamwoord
revelatie	zelfstandig naamwoord
rigiditeit	zelfstandig naamwoord
rijwiel	zelfstandig naamwoord
rijwielpad	zelfstandig naamwoord
robuustheid	zelfstandig naamwoord
ruchtbaarheid	zelfstandig naamwoord
sanctie	zelfstandig naamwoord
scepsis	zelfstandig naamwoord
schroom	zelfstandig naamwoord
scrupules	zelfstandig naamwoord
secularisatie	zelfstandig naamwoord
senioriteit	zelfstandig naamwoord
sensitiviteit	zelfstandig naamwoord
silhouet	zelfstandig naamwoord
simulant	zelfstandig naamwoord
sinecure	zelfstandig naamwoord
soberheid	zelfstandig naamwoord
soelaas	zelfstandig naamwoord
solidariteit	zelfstandig naamwoord
soliditeit	zelfstandig naamwoord
specificatie	zelfstandig naamwoord
spectrum	zelfstandig naamwoord
speculatie	zelfstandig naamwoord
spoed	zelfstandig naamwoord
sponde	zelfstandig naamwoord
stadium	zelfstandig naamwoord
strategie	zelfstandig naamwoord
subtiliteit	zelfstandig naamwoord
sujet	zelfstandig naamwoord
symbool	zelfstandig naamwoord
tafereel	zelfstandig naamwoord
tal van	zelfstandig naamwoord
tegemoetkoming	zelfstandig naamwoord
terechtwijzing	zelfstandig naamwoord
thematiek	zelfstandig naamwoord
tiental	zelfstandig naamwoord
tijdsbestek	zelfstandig naamwoord
tijdspanne	zelfstandig naamwoord
tirannie	zelfstandig naamwoord
tolerantie	zelfstandig naamwoord
toorn	zelfstandig naamwoord
totaliteit	zelfstandig naamwoord
transparantie	zelfstandig naamwoord
triomf	zelfstandig naamwoord
trivialiteit	zelfstandig naamwoord
trottoir	zelfstandig naamwoord
turbulentie	zelfstandig naamwoord
twaalftal	zelfstandig naamwoord
tweetal	zelfstandig naamwoord
twintigtal	zelfstandig naamwoord
uitdrukkelijkheid	zelfstandig naamwoord
uiteenzetting	zelfstandig naamwoord
uitweiding	zelfstandig naamwoord
unanimiteit	zelfstandig naamwoord
uniciteit	zelfstandig naamwoord
uniformiteit	zelfstandig naamwoord
urgentie	zelfstandig naamwoord
urinoir	zelfstandig naamwoord
usance	zelfstandig naamwoord
veertigtal	zelfstandig naamwoord
verachting	zelfstandig naamwoord
verantwoording	zelfstandig naamwoord
verbijstering	zelfstandig naamwoord
verbondenheid	zelfstandig naamwoord
verdorvenheid	zelfstandig naamwoord
vereiste	zelfstandig naamwoord
vergevingsgezindheid	zelfstandig naamwoord
verificatie	zelfstandig naamwoord
verkrijging	zelfstandig naamwoord
verloochening	zelfstandig naamwoord
vermaning	zelfstandig naamwoord
vermeldenswaardigheid	zelfstandig naamwoord
vermogen	zelfstandig naamwoord
verrukking	zelfstandig naamwoord
vervaardiging	zelfstandig naamwoord
verwerpelijkheid	zelfstandig naamwoord
verwevenheid	zelfstandig naamwoord
verwording	zelfstandig naamwoord
viertal	zelfstandig naamwoord
viertiental	zelfstandig naamwoord
vigilantie	zelfstandig naamwoord
vijftal	zelfstandig naamwoord
vijftiental	zelfstandig naamwoord
vijftigtal	zelfstandig naamwoord
viriliteit	zelfstandig naamwoord
virtuositeit	zelfstandig naamwoord
voedsel	zelfstandig naamwoord
voltooiing	zelfstandig naamwoord
voortgang	zelfstandig naamwoord
vraagstuk	zelfstandig naamwoord
vrees	zelfstandig naamwoord
vreugde	zelfstandig naamwoord
vulgariteit	zelfstandig naamwoord
weerlegging	zelfstandig naamwoord
weerslag	zelfstandig naamwoord
weigerachtigheid	zelfstandig naamwoord
welbehagen	zelfstandig naamwoord
werkwijze	zelfstandig naamwoord
wetenswaardigheid	zelfstandig naamwoord
wijziging	zelfstandig naamwoord
woning	zelfstandig naamwoord
zege	zelfstandig naamwoord
zestal	zelfstandig naamwoord
zevental	zelfstandig naamwoord
zienswijze	zelfstandig naamwoord
